Event	State	Country
New Farm parkrun	Queensland	Australia
Main Beach parkrun	Queensland	Australia
Kirra parkrun	Queensland	Australia
Coomera parkrun	Queensland	Australia
Wynnum parkrun	Queensland	Australia
North Lakes parkrun	Queensland	Australia
Kawana parkrun	Queensland	Australia
Riverway parkrun	Queensland	Australia
Sandgate parkrun	Queensland	Australia
South Bank parkrun	Queensland	Australia
Varsity Lakes parkrun	Queensland	Australia
Toowoomba parkrun	Queensland	Australia
Mitchelton parkrun	Queensland	Australia
Noosa parkrun	Queensland	Australia
Logan River parkrun	Queensland	Australia
North Shore parkrun	Queensland	Australia
Ipswich QLD parkrun	Queensland	Australia
Airlie Beach parkrun	Queensland	Australia
Gatton parkrun	Queensland	Australia
Cairns parkrun	Queensland	Australia
Cleveland parkrun	Queensland	Australia
Gladstone QLD parkrun	Queensland	Australia
Rocks Riverside parkrun	Queensland	Australia
Bunyaville parkrun	Queensland	Australia
Warwick parkrun	Queensland	Australia
Bargara parkrun	Queensland	Australia
Emerald parkrun	Queensland	Australia
Rockhampton parkrun	Queensland	Australia
Dalby parkrun	Queensland	Australia
Mudgeeraba parkrun	Queensland	Australia
Mackay parkrun	Queensland	Australia
Roma parkrun	Queensland	Australia
Hervey Bay parkrun	Queensland	Australia
Minnippi parkrun	Queensland	Australia
Calamvale parkrun	Queensland	Australia
Stanthorpe parkrun	Queensland	Australia
Golden Beach parkrun	Queensland	Australia
Tamborine Mountain parkrun	Queensland	Australia
Yeppoon parkrun	Queensland	Australia
Wishart parkrun	Queensland	Australia
Mount Isa parkrun	Queensland	Australia
Yarrabilba parkrun	Queensland	Australia
Pittsworth parkrun	Queensland	Australia
Central Lakes parkrun	Queensland	Australia
Capalaba parkrun	Queensland	Australia
Broadbeach Waters parkrun	Queensland	Australia
Redcliffe parkrun	Queensland	Australia
Berrinba parkrun	Queensland	Australia
St Lucia parkrun	Queensland	Australia
Chermside parkrun	Queensland	Australia
Atherton parkrun	Queensland	Australia
Brightwater parkrun	Queensland	Australia
Warner Lakes parkrun	Queensland	Australia
Maryborough parkrun	Queensland	Australia
Goondiwindi parkrun	Queensland	Australia
Forest Lake parkrun	Queensland	Australia
Hamilton Island parkrun	Queensland	Australia
Ashgrove parkrun	Queensland	Australia
Petrie parkrun	Queensland	Australia
Paradise Point parkrun	Queensland	Australia
Surfers Paradise parkrun	Queensland	Australia
Highfields parkrun	Queensland	Australia
Nambour parkrun	Queensland	Australia
Sirromet parkrun	Queensland	Australia
Kedron parkrun	Queensland	Australia
Bowen parkrun	Queensland	Australia
Meadowbrook parkrun	Queensland	Australia
Weipa parkrun	Queensland	Australia
Underwood Park parkrun	Queensland	Australia
Tannum Sands parkrun	Queensland	Australia
Wondai parkrun	Queensland	Australia
White Rock parkrun	Queensland	Australia
Bundaberg parkrun	Queensland	Australia
Redland Bay parkrun	Queensland	Australia
Mansfield parkrun, Queensland	Queensland	Australia
Greenbank parkrun	Queensland	Australia
Oakey parkrun	Queensland	Australia
Cloncurry parkrun	Queensland	Australia
Lota parkrun	Queensland	Australia
Miles parkrun	Queensland	Australia
St George parkrun	Queensland	Australia
North Harbour parkrun	Queensland	Australia
Zillmere parkrun	Queensland	Australia
Cardwell parkrun	Queensland	Australia
Plantation parkrun	Queensland	Australia
Kelvin Grove parkrun	Queensland	Australia
Aplins Weir parkrun	Queensland	Australia
Gainsborough Greens parkrun	Queensland	Australia
South Toowoomba parkrun	Queensland	Australia
Ocean View parkrun	Queensland	Australia
Cannonvale junior parkrun	Queensland	Australia
Cormorant Bay parkrun	Queensland	Australia
Pallara parkrun	Queensland	Australia
Mudjimba Beach parkrun	Queensland	Australia
Victory Heights Trail parkrun	Queensland	Australia
Baringa parkrun	Queensland	Australia
Yowie parkrun	Queensland	Australia
Graham Andrews parkrun	Queensland	Australia
Glass House Mountains Conservation parkrun	Queensland	Australia
Charleys Creek parkrun	Queensland	Australia
Harris Avenue parkrun	Queensland	Australia
Ros Gregor Trail parkrun	Queensland	Australia
Centenary parkrun	Queensland	Australia
Waterloo Plains parkrun	Queensland	Australia
TYTO Wetlands parkrun	Queensland	Australia
S.S. Koopa Trail parkrun	Queensland	Australia
Old Thomson River Road parkrun	Queensland	Australia
Maleny Trail parkrun	Queensland	Australia
Gayndah River Walk parkrun	Queensland	Australia
Bellevue Park junior parkrun	Queensland	Australia
Des Connor Park junior parkrun	Queensland	Australia
St Peters parkrun	New South Wales	Australia
Newy parkrun	New South Wales	Australia
Parramatta parkrun	New South Wales	Australia
Curl Curl parkrun	New South Wales	Australia
Kingscliff parkrun	New South Wales	Australia
Lake Mac parkrun	New South Wales	Australia
Fingal Bay parkrun	New South Wales	Australia
Sandon Point parkrun	New South Wales	Australia
North Wollongong parkrun	New South Wales	Australia
Batemans Bay parkrun	New South Wales	Australia
Tamworth parkrun	New South Wales	Australia
Nulkaba parkrun	New South Wales	Australia
Inverell parkrun	New South Wales	Australia
Mosman parkrun	New South Wales	Australia
Armidale parkrun	New South Wales	Australia
Merimbula parkrun	New South Wales	Australia
Bathurst parkrun	New South Wales	Australia
Port Macquarie parkrun	New South Wales	Australia
Blackbutt parkrun	New South Wales	Australia
Albury Wodonga parkrun	New South Wales	Australia
Maitland parkrun	New South Wales	Australia
Blue Gum Hills parkrun	New South Wales	Australia
Lakeview parkrun	New South Wales	Australia
Singleton parkrun	New South Wales	Australia
Yamba parkrun	New South Wales	Australia
Cooks River parkrun	New South Wales	Australia
Coffs Harbour parkrun	New South Wales	Australia
Campbelltown parkrun	New South Wales	Australia
Queanbeyan parkrun	New South Wales	Australia
Penrith Lakes parkrun	New South Wales	Australia
Rouse Hill parkrun	New South Wales	Australia
Mt Penang parkrun	New South Wales	Australia
Lawson parkrun	New South Wales	Australia
Mudgee parkrun	New South Wales	Australia
Bowral parkrun	New South Wales	Australia
Shellharbour parkrun	New South Wales	Australia
Cronulla parkrun	New South Wales	Australia
Lismore parkrun	New South Wales	Australia
Cowra parkrun	New South Wales	Australia
Stockton parkrun	New South Wales	Australia
Huskisson parkrun	New South Wales	Australia
Narrabri parkrun	New South Wales	Australia
The Beaches parkrun	New South Wales	Australia
Taree parkrun	New South Wales	Australia
Dubbo parkrun	New South Wales	Australia
Menai parkrun	New South Wales	Australia
Bill Rose Sports Complex parkrun	New South Wales	Australia
Goulburn parkrun	New South Wales	Australia
Chipping Norton parkrun	New South Wales	Australia
The Ponds parkrun	New South Wales	Australia
Rhodes parkrun	New South Wales	Australia
Callaghan parkrun	New South Wales	Australia
Bega parkrun	New South Wales	Australia
Grafton parkrun	New South Wales	Australia
The Terrace parkrun	New South Wales	Australia
Panania parkrun	New South Wales	Australia
The Entrance parkrun	New South Wales	Australia
Wagga parkrun	New South Wales	Australia
Wauchope parkrun	New South Wales	Australia
Moree parkrun	New South Wales	Australia
Orange parkrun	New South Wales	Australia
Galston parkrun	New South Wales	Australia
Willoughby parkrun	New South Wales	Australia
Nepean River parkrun	New South Wales	Australia
Kamay parkrun	New South Wales	Australia
Forster parkrun	New South Wales	Australia
Rooty Hill parkrun	New South Wales	Australia
Lithgow parkrun	New South Wales	Australia
Ballina Coast parkrun	New South Wales	Australia
Dolls Point parkrun	New South Wales	Australia
Urunga parkrun	New South Wales	Australia
East Richmond parkrun	New South Wales	Australia
San Remo parkrun	New South Wales	Australia
GreenWay parkrun	New South Wales	Australia
Wildflower parkrun	New South Wales	Australia
Picton parkrun	New South Wales	Australia
Cobar parkrun	New South Wales	Australia
North Sydney parkrun	New South Wales	Australia
Woy Woy parkrun	New South Wales	Australia
Jindabyne parkrun	New South Wales	Australia
Merriwa parkrun	New South Wales	Australia
Braidwood Showground parkrun	New South Wales	Australia
Cowpasture Reserve parkrun, Camden	New South Wales	Australia
Horseshoe Bay Reserve parkrun	New South Wales	Australia
Centennial parkrun	New South Wales	Australia
Bourke Racecourse parkrun	New South Wales	Australia
Narromine Wetlands parkrun	New South Wales	Australia
Queen Elizabeth parkrun, Casino	New South Wales	Australia
Broken Hill Racecourse parkrun	New South Wales	Australia
Werrington Lakes Reserve parkrun	New South Wales	Australia
Riverbank parkrun	New South Wales	Australia
Gloucester District parkrun	New South Wales	Australia
Walcha parkrun	New South Wales	Australia
Ted Scobie Oval parkrun	New South Wales	Australia
Pioneer Dairy parkrun	New South Wales	Australia
Casula Parklands parkrun	New South Wales	Australia
Northparkes Oval parkrun	New South Wales	Australia
Whalan Reserve parkrun	New South Wales	Australia
Avondale University College parkrun	New South Wales	Australia
Leeton Sport and Recreation Precinct parkrun	New South Wales	Australia
Albert parkrun, Melbourne	Victoria	Australia
Balyang Sanctuary parkrun	Victoria	Australia
Shepparton parkrun	Victoria	Australia
Warrnambool parkrun	Victoria	Australia
Highlands parkrun	Victoria	Australia
Hastings Foreshore parkrun	Victoria	Australia
Diamond Creek parkrun	Victoria	Australia
Ocean Grove parkrun	Victoria	Australia
Berwick Springs parkrun	Victoria	Australia
Point Cook parkrun	Victoria	Australia
Ballarat parkrun	Victoria	Australia
Westerfolds parkrun	Victoria	Australia
Torquay parkrun	Victoria	Australia
Lakes Entrance parkrun	Victoria	Australia
Lillydale Lake parkrun	Victoria	Australia
Sale parkrun	Victoria	Australia
Kennington Reservoir parkrun	Victoria	Australia
Maribyrnong parkrun	Victoria	Australia
Hamilton parkrun	Victoria	Australia
Pakenham parkrun	Victoria	Australia
Wangaratta parkrun	Victoria	Australia
Toolern Creek parkrun	Victoria	Australia
Frog Hollow parkrun	Victoria	Australia
Inverloch parkrun	Victoria	Australia
Parkville parkrun	Victoria	Australia
Brimbank parkrun	Victoria	Australia
Coburg parkrun	Victoria	Australia
Traralgon parkrun	Victoria	Australia
Warragul parkrun	Victoria	Australia
Mansfield Botanic parkrun	Victoria	Australia
Jells parkrun	Victoria	Australia
Lancefield parkrun	Victoria	Australia
Phillip Island parkrun	Victoria	Australia
Altona Beach parkrun	Victoria	Australia
Castlemaine parkrun	Victoria	Australia
Wyndham Vale parkrun	Victoria	Australia
Churchill parkrun	Victoria	Australia
Bairnsdale parkrun	Victoria	Australia
Studley parkrun	Victoria	Australia
Lalor parkrun	Victoria	Australia
Portland parkrun	Victoria	Australia
Cobram parkrun	Victoria	Australia
You Yangs parkrun	Victoria	Australia
Chelsea Bicentennial parkrun	Victoria	Australia
Wilson Botanic parkrun	Victoria	Australia
Karkarook parkrun	Victoria	Australia
Cohuna parkrun	Victoria	Australia
Port Fairy parkrun	Victoria	Australia
Mullum Mullum parkrun	Victoria	Australia
Newborough parkrun	Victoria	Australia
Darebin parkrun	Victoria	Australia
Ararat parkrun	Victoria	Australia
Echuca Moama parkrun	Victoria	Australia
Timboon parkrun	Victoria	Australia
Mount Beauty parkrun	Victoria	Australia
Mernda parkrun	Victoria	Australia
Newport Lakes parkrun	Victoria	Australia
Bannockburn Bush parkrun	Victoria	Australia
Portarlington parkrun	Victoria	Australia
Sunbury parkrun	Victoria	Australia
Marriott Waters parkrun	Victoria	Australia
Koonwarra parkrun	Victoria	Australia
Gardiners Creek parkrun	Victoria	Australia
Bright parkrun	Victoria	Australia
Nhill parkrun	Victoria	Australia
Rosebud parkrun	Victoria	Australia
Euroa parkrun	Victoria	Australia
Westerfolds junior parkrun	Victoria	Australia
Willow parkrun	Victoria	Australia
Eastern Gardens parkrun	Victoria	Australia
Wimmera River parkrun, Horsham	Victoria	Australia
KM Reedy Reserve parkrun	Victoria	Australia
Mildura Weir parkrun	Victoria	Australia
Lorne Beach parkrun	Victoria	Australia
Birdsland Reserve parkrun	Victoria	Australia
Grand Ridge Rail Trail parkrun, Mirboo North	Victoria	Australia
Berwick Waters parkrun	Victoria	Australia
Campaspe parkrun	Victoria	Australia
Goldfields Reservoir parkrun	Victoria	Australia
Benalla Botanical Gardens parkrun	Victoria	Australia
Aurora parkrun	Victoria	Australia
Wallaby Track parkrun	Victoria	Australia
Kerang Regional parkrun	Victoria	Australia
Warringal Parklands parkrun	Victoria	Australia
Dandenong parkrun	Victoria	Australia
Bendigo Botanic Gardens parkrun	Victoria	Australia
Peppertree parkrun	Victoria	Australia
Fairpark Reserve parkrun	Victoria	Australia
Eynesbury Heritage Trail junior parkrun	Victoria	Australia
Lake Boga Foreshore parkrun	Victoria	Australia
Louis Hamon Park parkrun	Victoria	Australia
Cascades on Clyde Wetlands parkrun	Victoria	Australia
Ovens River Trail parkrun	Victoria	Australia
Ginninderra parkrun	Australian Capital Territory	Australia
Tuggeranong parkrun	Australian Capital Territory	Australia
Gungahlin parkrun	Australian Capital Territory	Australia
Burley Griffin parkrun	Australian Capital Territory	Australia
Coombs parkrun	Australian Capital Territory	Australia
Mount Ainslie parkrun	Australian Capital Territory	Australia
Wagi Bridge parkrun	Australian Capital Territory	Australia
Claisebrook Cove parkrun	Western Australia	Australia
Rockingham parkrun	Western Australia	Australia
Canning River parkrun	Western Australia	Australia
Bunbury parkrun	Western Australia	Australia
Aveley parkrun	Western Australia	Australia
Lake Joondalup parkrun	Western Australia	Australia
Kalgoorlie-Boulder parkrun	Western Australia	Australia
Quinns Rocks parkrun	Western Australia	Australia
Manjimup parkrun	Western Australia	Australia
Pioneer parkrun	Western Australia	Australia
Cottesloe parkrun	Western Australia	Australia
Carine Glades parkrun	Western Australia	Australia
Geographe Bay parkrun	Western Australia	Australia
Mt Clarence parkrun	Western Australia	Australia
Bibra Lake parkrun	Western Australia	Australia
Dawesville parkrun	Western Australia	Australia
Moora parkrun	Western Australia	Australia
Kununurra parkrun	Western Australia	Australia
Champion Lakes parkrun	Western Australia	Australia
Woodbridge Riverside parkrun	Western Australia	Australia
Maylands Peninsula parkrun	Western Australia	Australia
Shelley parkrun	Western Australia	Australia
Calleya parkrun	Western Australia	Australia
Applecross parkrun	Western Australia	Australia
Port Hedland parkrun	Western Australia	Australia
Whitfords Nodes parkrun	Western Australia	Australia
Margaret River parkrun	Western Australia	Australia
Yokine parkrun	Western Australia	Australia
Wanneroo parkrun	Western Australia	Australia
Burswood Peninsula parkrun	Western Australia	Australia
Mount Helena parkrun	Western Australia	Australia
Shipwreck parkrun	Western Australia	Australia
Tamworth Wetlands parkrun	Western Australia	Australia
Perry Lakes parkrun	Western Australia	Australia
Marina parkrun	Western Australia	Australia
Collie River Trail parkrun	Western Australia	Australia
Kadina Trail parkrun	Western Australia	Australia
Mundy Regional parkrun	Western Australia	Australia
Edinburgh Oval parkrun	Western Australia	Australia
Garvey Park parkrun	Western Australia	Australia
Hampton Oval parkrun	Western Australia	Australia
Bayview Road parkrun	Western Australia	['Australia']
Risdon Brook parkrun	Tasmania	Australia
Launceston parkrun	Tasmania	Australia
Wynyard Foreshore parkrun	Tasmania	Australia
Devonport parkrun	Tasmania	Australia
George Town parkrun	Tasmania	Australia
Windsor Precinct parkrun	Tasmania	Australia
Railton parkrun	Tasmania	Australia
Queens Domain parkrun	Tasmania	Australia
Bellerive parkrun	Tasmania	Australia
Burnie parkrun	Tasmania	Australia
Port Sorell parkrun	Tasmania	Australia
Geeveston parkrun	Tasmania	Australia
Montrose Foreshore parkrun	Tasmania	Australia
Whitemark Wharf parkrun	Tasmania	Australia
Kingston Park parkrun	Tasmania	Australia
Our Park parkrun	Tasmania	Australia
Kate Reed parkrun	Tasmania	Australia
Torrens parkrun	South Australia	Australia
Mount Barker parkrun	South Australia	Australia
Mount Gambier parkrun	South Australia	Australia
Victor Harbor parkrun	South Australia	Australia
Murray Bridge parkrun	South Australia	Australia
Port Augusta parkrun	South Australia	Australia
Gawler parkrun	South Australia	Australia
Mawson Lakes parkrun	South Australia	Australia
Clare Valley parkrun	South Australia	Australia
Lochiel parkrun	South Australia	Australia
West Beach parkrun	South Australia	Australia
Strathalbyn parkrun	South Australia	Australia
Renmark parkrun	South Australia	Australia
Christies Beach parkrun	South Australia	Australia
Cleland parkrun	South Australia	Australia
Aldinga Beach parkrun	South Australia	Australia
Nuriootpa parkrun	South Australia	Australia
Port Lincoln parkrun	South Australia	Australia
Carisbrooke parkrun	South Australia	Australia
Kangaroo Island parkrun	South Australia	Australia
Reynella East parkrun	South Australia	Australia
Port Broughton parkrun	South Australia	Australia
Largs Bay parkrun	South Australia	Australia
Moana parkrun	South Australia	Australia
Edithburgh parkrun	South Australia	Australia
Goolwa parkrun	South Australia	Australia
Jubilee Way parkrun	South Australia	Australia
Meningie parkrun	South Australia	Australia
Pakapakanthi parkrun	South Australia	Australia
Seacliff Esplanade parkrun	South Australia	Australia
Stebonheath parkrun	South Australia	Australia
Charleston parkrun, South Australia	South Australia	Australia
Naracoorte Lake parkrun	South Australia	Australia
Yeldulknie Weir Trail parkrun	South Australia	Australia
Shiraz Trail parkrun	South Australia	Australia
Thorndon junior parkrun	South Australia	Australia
South Para Reservoir parkrun	South Australia	Australia
The Avenues parkrun	South Australia	Australia
Darwin parkrun	Northern Territory	Australia
Palmerston parkrun	Northern Territory	Australia
Nightcliff parkrun	Northern Territory	Australia
Nose Hill parkrun	Alberta	Canada
Okanagan parkrun	British Columbia	Canada
Richmond Olympic parkrun	British Columbia	Canada
Saint-Paulin parkrun	Quebec	Canada
Whitby parkrun	Ontario	Canada
Beach Strip parkrun	Ontario	Canada
Whistler parkrun	British Columbia	Canada
Frédéric Back parkrun	Quebec	Canada
Bellevue parkrun	Ontario	Canada
Clover Point parkrun	British Columbia	Canada
Kanata parkrun, Ottawa	Ontario	Canada
Penticton parkrun	British Columbia	Canada
Meadowvale parkrun	Ontario	Canada
North Bay parkrun	Ontario	Canada
Victoria parkrun, Kitchener	Ontario	Canada
River Oaks parkrun	Ontario	Canada
Wascana parkrun	Saskatchewan	Canada
Kiwanis parkrun	Ontario	Canada
Orleans parkrun	Ontario	Canada
Duffins Trail parkrun	Ontario	Canada
Trout Pond parkrun	Alberta	Canada
Henderson Lake parkrun	Alberta	Canada
Chain of Lakes parkrun	Nova Scotia	Canada
Avery Beach parkrun, Huntsville	Ontario	Canada
Nautical parkrun	Ontario	Canada
Gillies Lake parkrun	Ontario	Canada
Eramosa River Trail parkrun	Ontario	Canada
River Valley parkrun, Edmonton	Alberta	Canada
Churchill Parkway parkrun	Manitoba	Canada
Sunnidale parkrun	Ontario	Canada
Snye Point parkrun	Alberta	Canada
Central parkrun, Burnaby	British Columbia	Canada
Downsview parkrun	Ontario	Canada
Strathcona Island parkrun	Alberta	Canada
Mundy parkrun	British Columbia	Canada
Breakwater parkrun	Ontario	Canada
Shawnigan Hills parkrun	British Columbia	Canada
Mendel Riverbank parkrun	Saskatchewan	Canada
Victoria parkrun, Truro	Nova Scotia	Canada
Moussette parkrun	Quebec	Canada
Outlook and District Regional parkrun	Saskatchewan	Canada
George Lane Memorial parkrun	Alberta	Canada
Angrignon parkrun	Quebec	Canada
New York Central Fitness Trail parkrun	Ontario	Canada
Amager Fælled parkrun	Capital Region	Denmark
Nibe parkrun	North Denmark	Denmark
Fælledparken parkrun	Capital Region	Denmark
Brabrand parkrun	Central Jutland	Denmark
Esbjerg parkrun	South Denmark	Denmark
Vejen parkrun	South Denmark	Denmark
Amager Strandpark parkrun	Capital Region	Denmark
Nordre Fælled parkrun, Randers	Central Jutland	Denmark
Tampere parkrun	Pirkanmaa	Finland
Tokoinranta parkrun	Uusimaa	Finland
Vääksyn kanava parkrun	Paijat-Hame	Finland
parkrun des Dougnes, Cubnezais	Nouvelle-Aquitaine	France
parkrun du Bois de Boulogne, Paris	Île-de-France	France
parkrun du Château de Pierre de Bresse	Bourgogne-Franche-Comté	France
parkrun de la Ramée	Occitanie	France
parkrun de Montsouris	Île-de-France	France
parkrun de Fontainebleau	Île-de-France	France
parkrun du Lac de Divonne	Auvergne-Rhône-Alpes	France
parkrun de Rouen	Normandy	France
Neckarau parkrun	Baden-Württemberg	Germany
Rubbenbruchsee parkrun	Lower Saxony	Germany
Georgengarten parkrun	Lower Saxony	Germany
Küchenholz parkrun	Saxony	Germany
Nidda parkrun	Hesse	Germany
Hasenheide parkrun	Berlin	Germany
Wöhrder See parkrun	Bavaria	Germany
Kräherwald parkrun	Baden-Württemberg	Germany
Seewoog parkrun	Rheinland-Pfalz	Germany
Schwanenteich parkrun	Hesse	Germany
Pieschener Allee parkrun	Saxony	Germany
Leinpfad parkrun	Saarland	Germany
Alstervorland parkrun	Hamburg	Germany
Westpark parkrun	Bavaria	Germany
Rheinaue parkrun	North Rhine-Westphalia	Germany
Aachener Weiher parkrun	North Rhine-Westphalia	Germany
Neckarufer parkrun, Esslingen	Baden-Württemberg	Germany
Luitpold parkrun	Bavaria	Germany
Volksgarten parkrun	North Rhine-Westphalia	Germany
Kiessee parkrun	Lower Saxony	Germany
Monrepos parkrun	Baden-Württemberg	Germany
Unisee parkrun	Bremen	Germany
Riemer parkrun	Bavaria	Germany
Bugasee parkrun, Kassel	Hesse	Germany
Globe parkrun	Baden-Württemberg	Germany
Ziegelwiese parkrun	Saxony-Anhalt	Germany
Speyer Leinpfad parkrun	Rheinland-Pfalz	Germany
Grüner Weg parkrun	Baden-Württemberg	Germany
Oberwald parkrun	Baden-Württemberg	Germany
Kurt-Schumacher-Promenade parkrun	Bavaria	Germany
Lahnwiesen parkrun	Hesse	Germany
Dietenbach parkrun	Baden-Württemberg	Germany
Maaraue parkrun	Hesse	Germany
Friedrichsau parkrun	Baden-Württemberg	Germany
Hockgraben parkrun	Baden-Württemberg	Germany
Kurpark parkrun	Baden-Württemberg	Germany
Offenthal parkrun	Hesse	Germany
Rheinpark parkrun	North Rhine-Westphalia	Germany
Wittelsbacher Park parkrun	Bavaria	Germany
Sportpark Rems parkrun	Baden-Württemberg	Germany
Röthelheimpark parkrun	Bavaria	Germany
Landesgartenschau Park parkrun	Bavaria	Germany
Kastanienallee parkrun	Baden-Württemberg	Germany
Dreiländergarten parkrun	Baden-Württemberg	Germany
Navan parkrun	Leinster	Ireland
Malahide parkrun	Leinster	Ireland
Clonakilty parkrun	Munster	Ireland
Marlay parkrun	Leinster	Ireland
Castle Demense parkrun	Munster	Ireland
Griffeen parkrun	Leinster	Ireland
St Anne's parkrun	Leinster	Ireland
Westport parkrun	Connaught	Ireland
Ardgillan parkrun	Leinster	Ireland
Naas parkrun	Leinster	Ireland
Castlebar parkrun	Connaught	Ireland
Knocknacarra parkrun	Connaught	Ireland
Tymon parkrun	Leinster	Ireland
Oldbridge parkrun	Leinster	Ireland
Waterstown parkrun	Leinster	Ireland
Letterkenny parkrun	Ulster	Ireland
Bere Island parkrun	Munster	Ireland
Kilkenny parkrun	Leinster	Ireland
Vicarstown parkrun	Leinster	Ireland
Clarisford parkrun	Munster	Ireland
Poppintree parkrun	Leinster	Ireland
Cootehill parkrun	Ulster	Ireland
Ballina parkrun	Connaught	Ireland
Hartstown parkrun	Leinster	Ireland
Tralee parkrun	Munster	Ireland
Sligo parkrun	Connaught	Ireland
Wexford Racecourse parkrun	Leinster	Ireland
Lees Road parkrun	Munster	Ireland
Shanganagh parkrun	Leinster	Ireland
Cabinteely parkrun	Leinster	Ireland
New Ross parkrun	Leinster	Ireland
Dundalk parkrun	Leinster	Ireland
Castleblayney parkrun	Ulster	Ireland
Athlone parkrun	Leinster	Ireland
Father Collins parkrun	Leinster	Ireland
Donabate parkrun	Leinster	Ireland
Castletown parkrun	Leinster	Ireland
Porterstown parkrun	Leinster	Ireland
Rush junior parkrun	Leinster	Ireland
Limerick parkrun	Munster	Ireland
Glengarriff parkrun	Munster	Ireland
Tramore parkrun, Waterford	Munster	Ireland
Falcarragh parkrun	Ulster	Ireland
Castlehaven parkrun	Munster	Ireland
Erris parkrun	Connaught	Ireland
Vandeleur parkrun	Munster	Ireland
Dungloe parkrun	Ulster	Ireland
Ballina junior parkrun	Connaught	Ireland
Newcastle West parkrun	Munster	Ireland
Lough Key parkrun	Connaught	Ireland
Mullingar parkrun	Leinster	Ireland
Longford parkrun	Leinster	Ireland
Albert College junior parkrun	Leinster	Ireland
Ballincollig parkrun	Munster	Ireland
River Valley parkrun	Leinster	Ireland
Oranmore parkrun	Connaught	Ireland
Gorey parkrun	Leinster	Ireland
Tralee junior parkrun	Munster	Ireland
Templemore parkrun	Munster	Ireland
Bray junior parkrun	Leinster	Ireland
Russborough parkrun	Leinster	Ireland
Bushy parkrun, Dublin	Leinster	Ireland
St Anne's junior parkrun	Leinster	Ireland
Claremorris parkrun	Connaught	Ireland
Balbriggan junior parkrun	Leinster	Ireland
Tullow parkrun	Leinster	Ireland
Castlerea parkrun	Connaught	Ireland
Listowel parkrun	Munster	Ireland
Clonmel parkrun	Munster	Ireland
Longford junior parkrun	Leinster	Ireland
Mountlucas parkrun	Leinster	Ireland
Monaghan Town parkrun	Ulster	Ireland
Fairview parkrun	Leinster	Ireland
Corkagh parkrun	Leinster	Ireland
Vicarstown junior parkrun	Leinster	Ireland
Oranmore junior parkrun	Connaught	Ireland
Buncrana parkrun	Ulster	Ireland
Poolbeg parkrun	Leinster	Ireland
Carlow Town parkrun	Leinster	Ireland
Darndale parkrun	Leinster	Ireland
Deerpark junior parkrun	Leinster	Ireland
Marlay junior parkrun	Leinster	Ireland
Oughterard parkrun	Connaught	Ireland
Holywell junior parkrun	Leinster	Ireland
Tolka Valley parkrun	Leinster	Ireland
Brickfields parkrun	Leinster	Ireland
Portumna parkrun	Connaught	Ireland
Shelbourne junior parkrun	Munster	Ireland
Avondale Forest parkrun	Leinster	Ireland
Inch Beach parkrun	Munster	Ireland
Cobh junior parkrun	Munster	Ireland
Griffeen junior parkrun	Leinster	Ireland
Strokestown parkrun	Connaught	Ireland
Mungret parkrun	Munster	Ireland
Heritage Park junior parkrun	Leinster	Ireland
Tyrrelstown parkrun	Leinster	Ireland
Deerpark parkrun, Carlanstown	Leinster	Ireland
Glen River parkrun	Munster	Ireland
Lough Lannagh junior parkrun	Connaught	Ireland
Knockanacree Woods parkrun	Munster	Ireland
Burgess junior parkrun, County Tipperary	Munster	Ireland
Royal Canal parkrun, Kilcock	Leinster	Ireland
Clonbur Woods parkrun	Connaught	Ireland
Narin Beach parkrun	Ulster	Ireland
Malahide Castle junior parkrun	Leinster	Ireland
Ballincollig Regional junior parkrun	Munster	Ireland
Waterford Nature parkrun	Munster	Ireland
Killarney House parkrun	Munster	Ireland
Deerpark Forest parkrun, Virginia	Ulster	Ireland
Crosserlough junior parkrun	Ulster	Ireland
Coole parkrun	Connaught	Ireland
Ballyogan junior parkrun	Leinster	Ireland
Arklow Duck Pond junior parkrun	Leinster	Ireland
Con Smith parkrun	Ulster	Ireland
Borrisokane Town parkrun	Munster	Ireland
Rockfield junior parkrun	Leinster	Ireland
Cherry Orchard junior parkrun	Leinster	Ireland
Mallow Castle parkrun	Munster	Ireland
St Mary's Campus junior parkrun	Munster	Ireland
Achill Greenway parkrun	Connaught	Ireland
Illaunmanagh parkrun	Munster	Ireland
Beechpark junior parkrun	Leinster	Ireland
Pobalscoil na Tríonóide parkrun	Munster	Ireland
The Grand Canal Way parkrun, Tullamore	Leinster	Ireland
Porch Field parkrun	Leinster	Ireland
Dundalk IT junior parkrun	Leinster	Ireland
Ringsend junior parkrun	Leinster	Ireland
Uditore parkrun	Sicily	Italy
Marecchia parkrun	Emilia-Romagna	Italy
Milano Nord parkrun	Lombardy	Italy
Favorita parkrun	Sicily	Italy
Treviso parkrun	Veneto	Italy
Firenze parkrun	Tuscany	Italy
Etna parkrun	Sicily	Italy
Farfalle parkrun	Veneto	Italy
Roma Pineto parkrun	Latium	Italy
Montelepre parkrun	Sicily	Italy
Foro Italico parkrun	Sicily	Italy
Salento parkrun	Apulia	Italy
Mura di Lucca parkrun	Tuscany	Italy
Caffarella parkrun	Latium	Italy
Terme parkrun	Tuscany	Italy
Belloluogo parkrun	Apulia	Italy
La Mandria parkrun	Piedmont	Italy
Mensola parkrun	Tuscany	Italy
Futakotamagawa parkrun	Tokyo	Japan
Kashiwanoha parkrun	Chiba	Japan
Fukakitaryokuchi parkrun	Ōsaka	Japan
Oyodogawa shiminryokuchi parkrun	Miyazaki	Japan
Wataraseyusuichi parkrun	Tochigi	Japan
Horinouchi koen parkrun	Ehime	Japan
Yodogawa kasenkoen Hirakata chiku parkrun	Ōsaka	Japan
Shimanami Earthland parkrun	Ehime	Japan
Sanukikodomonokuni parkrun	Kagawa	Japan
Hirono kaigankoen parkrun	Shizuoka	Japan
Nagaragawa koen parkrun	Gifu	Japan
Odakaryokuchi parkrun	Aichi	Japan
Meijo koen parkrun	Aichi	Japan
Hikarigaoka koen parkrun	Tokyo	Japan
Kariyashi sogoundo koen parkrun	Aichi	Japan
Maborikaigan yuhodo parkrun	Kanagawa	Japan
Tsujido kaihin koen parkrun	Kanagawa	Japan
Momoi harappa koen parkrun	Tokyo	Japan
Oiso undokoen parkrun	Kanagawa	Japan
Shirahama koen parkrun	Aichi	Japan
Urayasushi sogo koen parkrun	Chiba	Japan
Hondajima parkrun	Aichi	Japan
Tamagawa chuo koen parkrun	Tokyo	Japan
Yuuka Family Road parkrun	Kumamoto	Japan
Shingashigawa Ukima parkrun	Tokyo	['Japan']
Taman Pudu Ulu parkrun	Kuala Lumpur	Malaysia
Presint 18 parkrun, Putrajaya	Putrajaya	Malaysia
Taman Tasik Danau Kota parkrun	Kuala Lumpur	Malaysia
Stadspark parkrun	Groningen	Netherlands
Kralingse Bos parkrun	South Holland	Netherlands
Amsterdamse Bos parkrun	North Holland	Netherlands
Máxima parkrun	Utrecht	Netherlands
Tapijn parkrun	Limburg	Netherlands
Goffert parkrun	Gelderland	Netherlands
Karpendonkse Plas parkrun	North Brabant	Netherlands
Kagerzoom parkrun	South Holland	Netherlands
Zuiderpark parkrun	South Holland	Netherlands
Schoterbos parkrun	North Holland	Netherlands
Sonsbeek parkrun	Gelderland	Netherlands
Lower Hutt parkrun	Wellington	New Zealand
Cornwall parkrun	Auckland	New Zealand
Barry Curtis parkrun	Auckland	New Zealand
Porirua parkrun	Wellington	New Zealand
Hamilton Lake parkrun	Waikato	New Zealand
Millwater parkrun	Auckland	New Zealand
Tauranga parkrun	Bay of Plenty	New Zealand
Kapiti Coast parkrun	Wellington	New Zealand
Western Springs parkrun	Auckland	New Zealand
Taupo parkrun	Waikato	New Zealand
Whangarei parkrun	Northland	New Zealand
Anderson parkrun	Hawke's Bay	New Zealand
Puarenga parkrun	Bay of Plenty	New Zealand
Cambridge NZ parkrun	Waikato	New Zealand
Palmerston North parkrun	Manawatu-Wanganui	New Zealand
Gisborne parkrun	Gisborne	New Zealand
East End parkrun, New Plymouth	Taranaki	New Zealand
Greytown Woodside Trail parkrun	Wellington	New Zealand
Hobsonville Point parkrun	Auckland	New Zealand
Flaxmere parkrun	Hawke's Bay	New Zealand
Whanganui Riverbank parkrun	Manawatu-Wanganui	New Zealand
University of Waikato parkrun	Waikato	New Zealand
Owairaka parkrun	Auckland	New Zealand
Trentham Memorial parkrun	Wellington	New Zealand
Dunedin parkrun	Otago	New Zealand
Hagley parkrun	Canterbury	New Zealand
Pegasus parkrun	Canterbury	New Zealand
Blenheim parkrun	Marlborough	New Zealand
Invercargill parkrun	Southland	New Zealand
Queenstown parkrun	Otago	New Zealand
Wanaka parkrun	Otago	New Zealand
Balclutha parkrun	Otago	New Zealand
Foster parkrun	Canterbury	New Zealand
Tøyen parkrun	Oslo	Norway
Stavanger parkrun	Rogaland	Norway
Løvstien parkrun, Bergen	Vestland	Norway
Festningen parkrun	Trøndelag	Norway
Dømmesmoen parkrun	Agder	Norway
Nansenparken parkrun	Viken	Norway
parkrun Gdynia	Pomerania	Poland
parkrun Gdańsk	Pomerania	Poland
parkrun Łódź	Łódź Voivodeship	Poland
parkrun Poznań	Greater Poland	Poland
parkrun Warszawa-Praga	Mazovia	Poland
parkrun Kraków	Lesser Poland	Poland
parkrun Wrocław	Lower Silesia	Poland
parkrun Szczecinek	West Pomerania	Poland
parkrun Żary	Lubusz	Poland
parkrun Leszno	Greater Poland	Poland
parkrun Cieszyn	Silesia	Poland
parkrun Konstancin-Jeziorna	Mazovia	Poland
parkrun Warszawa-Żoliborz	Mazovia	Poland
parkrun Kalisz	Greater Poland	Poland
parkrun Warszawa-Ursynów	Mazovia	Poland
parkrun Warszawa-Bródno	Mazovia	Poland
parkrun Świnoujście	West Pomerania	Poland
parkrun Pruszków	Mazovia	Poland
parkrun Kędzierzyn-Koźle	Opole Voivodeship	Poland
parkrun Bydgoszcz	Kujawsko-Pomorskie	Poland
parkrun Chrzanów	Lesser Poland	Poland
parkrun Kołobrzeg	West Pomerania	Poland
parkrun Rumia	Pomerania	Poland
parkrun Jelenia Góra	Lower Silesia	Poland
parkrun Opole	Opole Voivodeship	Poland
parkrun Lubin	Lower Silesia	Poland
parkrun Skierniewice	Łódź Voivodeship	Poland
parkrun Wolbrom	Lesser Poland	Poland
parkrun Toruń	Kujawsko-Pomorskie	Poland
parkrun Gostyń	Greater Poland	Poland
parkrun Szczecin	West Pomerania	Poland
parkrun Augustów	Podlasie	Poland
parkrun Pabianice	Łódź Voivodeship	Poland
parkrun Tczew	Pomerania	Poland
parkrun Katowice	Silesia	Poland
parkrun Białystok	Podlasie	Poland
parkrun Gdańsk-Południe	Pomerania	Poland
parkrun Jabłonna	Mazovia	Poland
parkrun Ełk	Warmia-Masuria	Poland
parkrun Świdwin	West Pomerania	Poland
parkrun Rzeszów	Subcarpathia	Poland
parkrun Tychy	Silesia	Poland
parkrun Kutno	Łódź Voivodeship	Poland
parkrun Grodzisk Mazowiecki	Mazovia	Poland
parkrun Działdowo	Warmia-Masuria	Poland
parkrun Dąbrówka	Greater Poland	Poland
parkrun Kościan	Greater Poland	Poland
parkrun Głogów	Lower Silesia	Poland
parkrun Gorzów Wielkopolski	Lubusz	Poland
parkrun Olsztyn	Warmia-Masuria	Poland
parkrun Koszalin	West Pomerania	Poland
parkrun Skórzec	Mazovia	Poland
parkrun Charzykowy	Pomerania	Poland
parkrun Chełm	Lublin	Poland
parkrun Zielona Góra	Lubusz	Poland
parkrun Grudziądz	Kujawsko-Pomorskie	Poland
parkrun Dzierzgoń	Pomerania	Poland
parkrun Jezioro Górne, Kętrzyn	Warmia-Masuria	Poland
parkrun Pole Mokotowskie	Mazovia	Poland
parkrun Park Zdrojowy, Kudowa-Zdrój	Lower Silesia	Poland
parkrun Park na Wyspie, Piła	Greater Poland	Poland
parkrun Jezioro Swarzędzkie	Greater Poland	Poland
parkrun Słodowo, Włocławek	Kujawsko-Pomorskie	Poland
parkrun Jezioro Zatorze, Konin	Greater Poland	Poland
parkrun Las Aniołowski	Silesia	Poland
parkrun Park Miejski, Wejherowo	Pomerania	Poland
parkrun Zamek w Malborku	Pomerania	Poland
parkrun Ogród Saski, Lublin	Lublin	Poland
parkrun Szubianki, Zagórów	Greater Poland	Poland
parkrun Mały Jeziorak	Warmia-Masuria	Poland
parkrun Park im. Jana Pawła II	Lublin	Poland
parkrun Zalew Żyrardowski	Mazovia	Poland
parkrun Rezerwat Strzelnica	Pomerania	Poland
parkrun Bulwar nad Wisłą	Silesia	Poland
parkrun Park Modrzewie	Warmia-Masuria	Poland
parkrun Park Radolińskich	Greater Poland	Poland
parkrun Puszcza Niepołomicka	Lesser Poland	Poland
parkrun Ekomarina	Warmia-Masuria	Poland
parkrun Las Dębiński	Greater Poland	Poland
parkrun Kolomenskoe	Moscow	Russia
parkrun Severnoe Tushino	Moscow	Russia
parkrun Gorky Park	Moscow	Russia
parkrun Izmailovo	Moscow	Russia
parkrun Mitino	Moscow Oblast	Russia
parkrun Timiryazevsky	Moscow	Russia
parkrun Zelenograd	Moscow	Russia
parkrun Bitsa	Moscow	Russia
parkrun Krylatskoe	Moscow	Russia
parkrun Tsaritsyno	Moscow	Russia
parkrun Butovo	Moscow	Russia
parkrun Sokolniki	Moscow	Russia
parkrun Vernadskogo	Moscow	Russia
parkrun Kuzminki	Moscow	Russia
parkrun Olimpiyskaya Derevnya	Moscow	Russia
parkrun Druzhba	Moscow	Russia
parkrun Babushkinsky na Yauze	Moscow	Russia
parkrun Chertanovo Pokrovsky Park	Moscow	Russia
parkrun Angarskie Prudy	Moscow	Russia
parkrun Pokrovskoe-Streshnevo	Moscow	Russia
parkrun Mikhalkovo	Moscow	Russia
parkrun Fili	Moscow	Russia
parkrun Filatov Lug	Moscow	Russia
parkrun Stavropol	Stavropol’ Kray	Russia
parkrun Elagin Ostrov	St.-Petersburg	Russia
parkrun Sosnovka	St.-Petersburg	Russia
parkrun Moskovsky Park Pobedy	St.-Petersburg	Russia
parkrun Kolpino	St.-Petersburg	Russia
parkrun Mega Park Kudrovo	Leningradskaya Oblast'	Russia
parkrun Shuvalovsky Park	St.-Petersburg	Russia
parkrun Pushkin	St.-Petersburg	Russia
parkrun Petergof Aleksandriysky	St.-Petersburg	Russia
parkrun Internatsionalistov	St.-Petersburg	Russia
parkrun Ryazan Central	Ryazan Oblast	Russia
parkrun Strelka	Jaroslavl	Russia
parkrun Tambov	Tambov	Russia
parkrun Tula Central	Tula	Russia
parkrun Kimry	Tver’ Oblast	Russia
parkrun Obninsk	Kaluga	Russia
parkrun Voronezh Central Park	Voronezj	Russia
parkrun Ryazan Oreshek	Ryazan Oblast	Russia
parkrun Readovsky Park	Smolenskaya Oblast’	Russia
parkrun Belgorod Park Pobedy	Belgorod Oblast	Russia
parkrun Kolchugino City Park	Vladimir	Russia
parkrun Starye Sady	Vladimir	Russia
parkrun Noginsk Gorodskoy Park	Moscow Oblast	Russia
parkrun Memorialny Park	Orel Oblast	Russia
parkrun Boeva Dacha	Kursk	Russia
parkrun Gubernsky Park	Kaluga	Russia
parkrun Tver Rechnoy Vokzal	Tver’ Oblast	Russia
parkrun Kazan Central	Tatarstan Republic	Russia
parkrun Ufa Botanichesky Sad	Bashkortostan Republic	Russia
parkrun Perm Balatovo	Perm	Russia
parkrun Samara Park Gagarina	Samara Oblast	Russia
parkrun Cheboksary naberezhnaya	Chuvashia	Russia
parkrun Orsk Park Stroiteley	Orenburg Oblast	Russia
parkrun Nizhny Novgorod Meshchersky	Nizhny Novgorod Oblast	Russia
parkrun Park Guskova	Orenburg Oblast	Russia
parkrun Park Kirova	Udmurtiya Republic	Russia
parkrun Gorodskoy Park Semya	Tatarstan Republic	Russia
parkrun Yoshkar-Ola Alleya Zdorovya	Mariy-El Republic	Russia
parkrun Yarmarochnaya Ploshchad	Tatarstan Republic	Russia
parkrun Buzuluk Park Pushkina	Orenburg Oblast	Russia
parkrun Chelyabinsk	Chelyabinsk	Russia
parkrun Chelyabinsk Ekopark	Chelyabinsk	Russia
parkrun Zatyumensky	Tyumen’ Oblast	Russia
parkrun Kurgan Central Park	Kurgan Oblast	Russia
parkrun Plotinka	Sverdlovsk	Russia
parkrun Volgograd Panorama	Volgograd Oblast	Russia
parkrun Rostov on Don	Rostov	Russia
parkrun Solnechny ostrov	Krasnodarskiy	Russia
parkrun Maykop Gorodskoy Park	Adygeya Republic	Russia
parkrun Petrovskaya naberezhnaya	Astrakhan	Russia
parkrun Novosibirsk naberezhnaya	Novosibirsk Oblast	Russia
parkrun Skver Dzerzhinskogo	Omsk	Russia
parkrun Krasnoyarsk Naberezhnaya	Krasnoyarskiy	Russia
parkrun Tomsk Stadion Polytechnic	Tomsk Oblast	Russia
parkrun Strezhevoy Gorodskoy Park	Tomsk Oblast	Russia
parkrun Komsomolsky	Kemerovo Oblast	Russia
parkrun Meshchersky	Moscow Oblast	Russia
parkrun Zhukovsky	Moscow Oblast	Russia
parkrun Dolgoprudny	Moscow Oblast	Russia
parkrun Khimki	Moscow Oblast	Russia
parkrun Pavlovsky Posad	Moscow Oblast	Russia
parkrun Korolev	Moscow Oblast	Russia
parkrun Balashikha Zarechnaya	Moscow Oblast	Russia
parkrun Natashinsky	Moscow Oblast	Russia
parkrun Serpukhov Gorodskoy Bor	Moscow Oblast	Russia
parkrun Ramenskoe Gorodskoy Park	Moscow Oblast	Russia
parkrun Lesopark Severny	Moscow Oblast	Russia
parkrun Lobnya Gorodskoy Park	Moscow Oblast	Russia
parkrun Park Talalikhina	Moscow	Russia
parkrun Mytishchi Central Park	Moscow Oblast	Russia
parkrun Yakutsk Dokhsun	Sakha	Russia
parkrun Gatchina Prioratsky	Leningradskaya Oblast'	Russia
parkrun Velikiy Novgorod Kremlevsky	Novgorod Oblast	Russia
parkrun Naberezhnaya Reki Velikoy	Pskov Oblast	Russia
parkrun Nizhny Prud	Kaliningrad	Russia
parkrun Pur-Navolok	Arkhangelskaya	Russia
East Coast Park parkrun	Singapore	Singapore
West Coast Park parkrun	Singapore	Singapore
Bishan parkrun	Singapore	Singapore
Bedok Reservoir parkrun	Singapore	Singapore
Delta parkrun	Gauteng	South Africa
Modderfontein Reserve parkrun	Gauteng	South Africa
Woodlands parkrun	Gauteng	South Africa
Bryanston parkrun	Gauteng	South Africa
Rietvlei parkrun, JHB South	Gauteng	South Africa
Lonehill parkrun	Gauteng	South Africa
Alberts Farm parkrun	Gauteng	South Africa
Golden Harvest parkrun	Gauteng	South Africa
Westbury parkrun	Gauteng	South Africa
Lanseria parkrun	Gauteng	South Africa
Ernest Ullmann parkrun	Gauteng	South Africa
Bezuidenhout parkrun	Gauteng	South Africa
Atholl parkrun	Gauteng	South Africa
Waterfall parkrun	Gauteng	South Africa
Wits parkrun	Gauteng	South Africa
Rose parkrun, Lenasia	Gauteng	South Africa
Bosmont Stadium parkrun	Gauteng	South Africa
Bells Inn parkrun	Gauteng	South Africa
Doornkop Military Base parkrun	Gauteng	South Africa
Gracepoint parkrun	Gauteng	South Africa
Voortrekker Monument parkrun, Pretoria	Gauteng	South Africa
Laudium parkrun	Gauteng	South Africa
Botanical Garden parkrun	Gauteng	South Africa
Valhalla parkrun	Gauteng	South Africa
Bronberrik parkrun	Gauteng	South Africa
Hillside parkrun	Gauteng	South Africa
Roses parkrun	Gauteng	South Africa
Bronkhorstspruit parkrun	Gauteng	South Africa
Hazeldean Farm parkrun	Gauteng	South Africa
Upington parkrun	Northern Cape	South Africa
Kimberley parkrun	Northern Cape	South Africa
Springbok parkrun	Northern Cape	South Africa
Kathu parkrun	Northern Cape	South Africa
Aggeneys parkrun	Northern Cape	South Africa
Loxton parkrun	Northern Cape	South Africa
The Venue parkrun	Northern Cape	South Africa
Sutherland parkrun	Northern Cape	South Africa
Prieska parkrun	Northern Cape	South Africa
Uvongo parkrun	KwaZulu-Natal	South Africa
North Beach parkrun	KwaZulu-Natal	South Africa
Amanzimtoti parkrun	KwaZulu-Natal	South Africa
Umhlanga parkrun	KwaZulu-Natal	South Africa
Ballito parkrun	KwaZulu-Natal	South Africa
Richards Bay parkrun	KwaZulu-Natal	South Africa
Umdoni parkrun	KwaZulu-Natal	South Africa
KwaMashu parkrun	KwaZulu-Natal	South Africa
Tinley Manor parkrun	KwaZulu-Natal	South Africa
Umfolozi parkrun	KwaZulu-Natal	South Africa
Durban Point parkrun	KwaZulu-Natal	South Africa
Blue Lagoon parkrun	KwaZulu-Natal	South Africa
Hluhluwe parkrun	KwaZulu-Natal	South Africa
Dusi parkrun	KwaZulu-Natal	South Africa
Shongweni parkrun	KwaZulu-Natal	South Africa
Cannibals Cave parkrun	KwaZulu-Natal	South Africa
Piggly Wiggly parkrun	KwaZulu-Natal	South Africa
Pongola parkrun	KwaZulu-Natal	South Africa
Grey Goose parkrun	KwaZulu-Natal	South Africa
Thousand Hills parkrun	KwaZulu-Natal	South Africa
Winterton parkrun	KwaZulu-Natal	South Africa
Ladysmith parkrun	KwaZulu-Natal	South Africa
Nottingham Road parkrun	KwaZulu-Natal	South Africa
Westville parkrun	KwaZulu-Natal	South Africa
Ashburton parkrun	KwaZulu-Natal	South Africa
Vryheid parkrun	KwaZulu-Natal	South Africa
Hilton parkrun	KwaZulu-Natal	South Africa
Polokwane parkrun	Limpopo	South Africa
Mogol parkrun	Limpopo	South Africa
Leeupoort parkrun	Limpopo	South Africa
Modimolle parkrun	Limpopo	South Africa
Louis Trichardt parkrun	Limpopo	South Africa
Doornhoek Farm parkrun	Limpopo	South Africa
Kameeldoring parkrun	Limpopo	South Africa
Tzaneen parkrun	Limpopo	South Africa
Halls parkrun, Nelspruit	Mpumalanga	South Africa
White River parkrun	Mpumalanga	South Africa
Nkomazi parkrun	Mpumalanga	South Africa
Hoedspruit parkrun	Limpopo	South Africa
Hazyview parkrun	Mpumalanga	South Africa
Barberton parkrun	Mpumalanga	South Africa
Jock Trail parkrun	Mpumalanga	South Africa
Mashishing parkrun	Mpumalanga	South Africa
Middelburg parkrun	Mpumalanga	South Africa
Secunda parkrun	Mpumalanga	South Africa
Witbank parkrun	Mpumalanga	South Africa
Dullstroom parkrun	Mpumalanga	South Africa
Standerton parkrun	Mpumalanga	South Africa
Kralinbergh parkrun	Mpumalanga	South Africa
Red Star parkrun	Mpumalanga	South Africa
Piet Retief parkrun	Mpumalanga	South Africa
Weavers Country Estate parkrun	Mpumalanga	South Africa
Parys parkrun	Orange Free State	South Africa
Harrismith parkrun	Orange Free State	South Africa
Heron Banks parkrun	Orange Free State	South Africa
Ladybrand parkrun	Orange Free State	South Africa
Ventersburg parkrun	Orange Free State	South Africa
Langenhoven parkrun	Orange Free State	South Africa
Kroonstad parkrun	Orange Free State	South Africa
Welkom parkrun	Orange Free State	South Africa
Heidedal parkrun	Orange Free State	South Africa
Bethlehem parkrun	Orange Free State	South Africa
Jacobsdal parkrun	Orange Free State	South Africa
Vrede parkrun	Orange Free State	South Africa
Hoopstad parkrun	Orange Free State	South Africa
Sand River parkrun, Virginia	Orange Free State	South Africa
Senekal parkrun	Orange Free State	South Africa
Ficksburg parkrun	Orange Free State	South Africa
Clarens parkrun	Orange Free State	South Africa
Brandkop parkrun	Orange Free State	South Africa
Steynsrus Showground parkrun	Orange Free State	South Africa
Potchefstroom parkrun	North-West	South Africa
Lebone parkrun	North-West	South Africa
Hartbeespoort parkrun	North-West	South Africa
Koster parkrun	North-West	South Africa
Christiana parkrun	North-West	South Africa
Vryburg parkrun	North-West	South Africa
Bloemhof parkrun	North-West	South Africa
Goodwill parkrun	North-West	South Africa
Lichtenburg Raceway parkrun	North-West	South Africa
Matlosana Bird parkrun	North-West	South Africa
Nahoon Point parkrun	Eastern Cape	South Africa
Sunrise-on-Sea parkrun	Eastern Cape	South Africa
Kidds Beach parkrun	Eastern Cape	South Africa
PE Hobie Beach parkrun	Eastern Cape	South Africa
St Francis parkrun	Eastern Cape	South Africa
Port Alfred parkrun	Eastern Cape	South Africa
Lady Slipper parkrun	Eastern Cape	South Africa
Sardinia Bay parkrun	Eastern Cape	South Africa
Jeffreys Bay parkrun	Eastern Cape	South Africa
iMonti parkrun	Eastern Cape	South Africa
Wells Estate parkrun	Eastern Cape	South Africa
Kei Mouth parkrun	Eastern Cape	South Africa
Adrenalin Addo parkrun	Eastern Cape	South Africa
Langebaan parkrun	Western Cape	South Africa
Malmesbury parkrun	Western Cape	South Africa
Vredendal parkrun	Western Cape	South Africa
Yzerfontein parkrun	Western Cape	South Africa
Rondebosch Common parkrun	Western Cape	South Africa
Big Bay parkrun	Western Cape	South Africa
Greenpoint parkrun	Western Cape	South Africa
Fish Hoek parkrun	Western Cape	South Africa
Century City parkrun	Western Cape	South Africa
Bellville parkrun	Western Cape	South Africa
Durbanville parkrun	Western Cape	South Africa
Constantia Greenbelt parkrun	Western Cape	South Africa
Zandvlei parkrun	Western Cape	South Africa
Mitchells Plain parkrun	Western Cape	South Africa
Bridgetown parkrun	Western Cape	South Africa
Hout Bay parkrun	Western Cape	South Africa
Melkbosstrand parkrun	Western Cape	South Africa
Mofolo parkrun	Gauteng	South Africa
Mapetla parkrun	Gauteng	South Africa
Root 44 parkrun	Western Cape	South Africa
Wellington parkrun	Western Cape	South Africa
Paarl parkrun	Western Cape	South Africa
Franschhoek parkrun	Western Cape	South Africa
Somerset West parkrun	Western Cape	South Africa
Breede Valley parkrun	Western Cape	South Africa
Kayamandi parkrun	Western Cape	South Africa
Ceres parkrun	Western Cape	South Africa
Robertson parkrun	Western Cape	South Africa
Duikersdrift parkrun, Tulbagh	Western Cape	South Africa
Strand Beach parkrun	Western Cape	South Africa
Swakopmund parkrun	Erongo	Namibia
Walvis Bay parkrun	Erongo	Namibia
Windhoek parkrun	Khomas	Namibia
Omeya parkrun	Khomas	Namibia
Mbabane parkrun	Hhohho	Eswatini
Grahamstown parkrun	Eastern Cape	South Africa
Stutterheim parkrun	Eastern Cape	South Africa
Aliwal North parkrun	Eastern Cape	South Africa
Hogsback parkrun	Eastern Cape	South Africa
Komani parkrun	Eastern Cape	South Africa
Mthatha parkrun	Eastern Cape	South Africa
Mountain Drive parkrun, Graaff-Reinet	Eastern Cape	South Africa
Alice Campus parkrun, University of Fort Hare	Eastern Cape	South Africa
Meyerton parkrun	Gauteng	South Africa
Vaal Marina parkrun	Gauteng	South Africa
Drumblade parkrun	Gauteng	South Africa
Riviera on Vaal parkrun	Gauteng	South Africa
Silveroaks parkrun	Gauteng	South Africa
Phoenix Park parkrun	Gauteng	South Africa
Roodepoort parkrun	Gauteng	South Africa
Kraalkop parkrun	Gauteng	South Africa
Ruimsig parkrun	Gauteng	South Africa
Sterkfontein parkrun	Gauteng	South Africa
Westonaria parkrun	Gauteng	South Africa
Randfontein parkrun	Gauteng	South Africa
George parkrun	Western Cape	South Africa
Knysna parkrun	Western Cape	South Africa
Harkerville parkrun	Western Cape	South Africa
Outeniquasbosch parkrun	Western Cape	South Africa
Oudtshoorn parkrun	Western Cape	South Africa
Prince Albert parkrun	Western Cape	South Africa
Hermanus parkrun	Western Cape	South Africa
Swellendam parkrun	Western Cape	South Africa
Betty's Bay parkrun	Western Cape	South Africa
Grabouw parkrun	Western Cape	South Africa
Bredasdorp parkrun	Western Cape	South Africa
Villiersdorp parkrun	Western Cape	South Africa
Groeneweide parkrun	Western Cape	South Africa
Ebotse parkrun	Gauteng	South Africa
Boksburg parkrun	Gauteng	South Africa
Gilloolys parkrun	Gauteng	South Africa
Victoria Lake parkrun	Gauteng	South Africa
Midstream parkrun	Gauteng	South Africa
Springs parkrun	Gauteng	South Africa
Rondebult parkrun	Gauteng	South Africa
Brakpan parkrun	Gauteng	South Africa
Atlasville parkrun	Gauteng	South Africa
Bulithando parkrun	Gauteng	South Africa
Edenvale parkrun	Gauteng	South Africa
Meyers Farm parkrun	Gauteng	South Africa
Homestead Lake parkrun	Gauteng	South Africa
Tsakane Wetlands parkrun	Gauteng	South Africa
Ferryvale parkrun	Gauteng	South Africa
Riverfields parkrun	Gauteng	South Africa
Leeupan parkrun	Gauteng	South Africa
Greenstone Hill parkrun	Gauteng	South Africa
Kwanele parkrun	Gauteng	South Africa
Haga parkrun	Stockholm	Sweden
Örebro parkrun	Örebro	Sweden
Huddinge parkrun	Stockholm	Sweden
Skatås parkrun	Västra Götaland	Sweden
Kungsängen parkrun	Stockholm	Sweden
Malmö Ribersborg parkrun	Skåne	Sweden
Uppsala parkrun	Uppsala	Sweden
Vallaskogen parkrun	Östergötland	Sweden
Växjösjön parkrun	Kronoberg	Sweden
Norre Katts parkrun	Halland	Sweden
Badhusparken parkrun	Jämtland	Sweden
Pollok parkrun, Glasgow	Scotland	United Kingdom
Edinburgh parkrun	Scotland	United Kingdom
Rouken Glen junior parkrun	Scotland	United Kingdom
Aberdeen parkrun	Scotland	United Kingdom
Plean parkrun	Scotland	United Kingdom
The Meadows junior parkrun	Scotland	United Kingdom
Aviemore parkrun	Scotland	United Kingdom
Strathclyde parkrun	Scotland	United Kingdom
Camperdown parkrun, Dundee	Scotland	United Kingdom
Eglinton parkrun	Scotland	United Kingdom
Greenock parkrun	Scotland	United Kingdom
Stonehaven parkrun	Scotland	United Kingdom
Falkirk parkrun	Scotland	United Kingdom
Inverleith junior parkrun	Scotland	United Kingdom
Montrose parkrun	Scotland	United Kingdom
Perth parkrun	Scotland	United Kingdom
St Andrews parkrun	Scotland	United Kingdom
Inverness parkrun	Scotland	United Kingdom
Duthie junior parkrun	Scotland	United Kingdom
Loch Leven junior parkrun	Scotland	United Kingdom
Dumfries junior parkrun	Scotland	United Kingdom
Troon parkrun	Scotland	United Kingdom
Vogrie parkrun	Scotland	United Kingdom
Ayr parkrun	Scotland	United Kingdom
Bressay parkrun	Scotland	United Kingdom
Livingston parkrun	Scotland	United Kingdom
Helix junior parkrun	Scotland	United Kingdom
Linwood parkrun	Scotland	United Kingdom
Strathmartine junior parkrun	Scotland	United Kingdom
Crichton parkrun	Scotland	United Kingdom
Ganavan Sands parkrun	Scotland	United Kingdom
Tollcross parkrun, Glasgow	Scotland	United Kingdom
Victoria parkrun, Glasgow	Scotland	United Kingdom
Hazlehead parkrun, Aberdeen	Scotland	United Kingdom
Alness parkrun	Scotland	United Kingdom
Ruchill parkrun	Scotland	United Kingdom
Kirkcaldy parkrun	Scotland	United Kingdom
Springburn parkrun, Glasgow	Scotland	United Kingdom
Portobello parkrun, Edinburgh	Scotland	United Kingdom
Stirling junior parkrun	Scotland	United Kingdom
Victoria junior parkrun, Glasgow	Scotland	United Kingdom
Dunfermline parkrun	Scotland	United Kingdom
Ellon parkrun	Scotland	United Kingdom
Perth junior parkrun	Scotland	United Kingdom
Elgin parkrun	Scotland	United Kingdom
Drumchapel parkrun	Scotland	United Kingdom
Prestwick Oval junior parkrun	Scotland	United Kingdom
Jacks Road junior parkrun	Scotland	United Kingdom
Thurso parkrun	Scotland	United Kingdom
Fort William parkrun	Scotland	United Kingdom
Kirkwall parkrun	Scotland	United Kingdom
Lochore Meadows parkrun	Scotland	United Kingdom
Barshaw junior parkrun	Scotland	United Kingdom
Girvan Prom parkrun	Scotland	United Kingdom
Lanark Moor parkrun	Scotland	United Kingdom
Loch Leven parkrun	Scotland	United Kingdom
Hay Lodge parkrun	Scotland	United Kingdom
Crathes Castle parkrun	Scotland	United Kingdom
Meadowmill parkrun	Scotland	United Kingdom
Lochend Woods parkrun	Scotland	United Kingdom
MacRosty junior parkrun	Scotland	United Kingdom
Polkemmet Country parkrun	Scotland	United Kingdom
Duloch junior parkrun	Scotland	United Kingdom
Drumpellier Country parkrun	Scotland	United Kingdom
Dean Castle Country Park parkrun	Scotland	United Kingdom
Mount Stuart parkrun	Scotland	United Kingdom
University of Stirling parkrun	Scotland	United Kingdom
Ury Riverside parkrun	Scotland	United Kingdom
Queen's parkrun, Glasgow	Scotland	United Kingdom
Oriam parkrun	Scotland	United Kingdom
Agnew parkrun	Scotland	United Kingdom
Levengrove parkrun	Scotland	United Kingdom
Battery Park junior parkrun	Scotland	United Kingdom
Lews Castle parkrun	Scotland	United Kingdom
Wallaceneuk parkrun	Scotland	United Kingdom
Drumpellier junior parkrun	Scotland	United Kingdom
Faskally Forest parkrun	Scotland	United Kingdom
Elder Park junior parkrun	Scotland	United Kingdom
Bankton Mains Park junior parkrun	Scotland	United Kingdom
Bramhall parkrun	England	United Kingdom
Heaton parkrun	England	United Kingdom
Woodbank parkrun	England	United Kingdom
South Manchester parkrun	England	United Kingdom
Preston parkrun	England	United Kingdom
Hyndburn parkrun	England	United Kingdom
Keswick junior parkrun	England	United Kingdom
Skelmersdale junior parkrun	England	United Kingdom
Oldham parkrun	England	United Kingdom
Millom parkrun	England	United Kingdom
Hyde parkrun	England	United Kingdom
Phoenix parkrun	England	United Kingdom
Knowsley parkrun	England	United Kingdom
St Helens parkrun	England	United Kingdom
Widnes junior parkrun	England	United Kingdom
Burnley junior parkrun	England	United Kingdom
Carlisle parkrun	England	United Kingdom
Clitheroe Castle junior parkrun	England	United Kingdom
Avenham Park junior parkrun	England	United Kingdom
Queen's Park junior parkrun, Rochdale	England	United Kingdom
Warrington parkrun	England	United Kingdom
Southport parkrun	England	United Kingdom
Queen's Park junior parkrun, Bolton	England	United Kingdom
Congleton parkrun	England	United Kingdom
Salford junior parkrun	England	United Kingdom
Chester parkrun	England	United Kingdom
Pennington Flash parkrun	England	United Kingdom
Princes parkrun, Liverpool	England	United Kingdom
Stanley Park junior parkrun	England	United Kingdom
Bolton parkrun	England	United Kingdom
Barrow parkrun	England	United Kingdom
Wythenshawe parkrun	England	United Kingdom
Worsley Woods parkrun	England	United Kingdom
Marple parkrun	England	United Kingdom
Burnley parkrun	England	United Kingdom
Burnage parkrun	England	United Kingdom
Delamere parkrun	England	United Kingdom
Workington parkrun	England	United Kingdom
Cuerden Valley parkrun	England	United Kingdom
Hyde junior parkrun	England	United Kingdom
Penrith parkrun	England	United Kingdom
Ormskirk parkrun	England	United Kingdom
Lyme Park parkrun	England	United Kingdom
Keswick parkrun	England	United Kingdom
Marple junior parkrun	England	United Kingdom
Pendle parkrun	England	United Kingdom
Cheadle Hulme parkrun	England	United Kingdom
Watergrove parkrun, Rochdale	England	United Kingdom
South Manchester junior parkrun	England	United Kingdom
Whinlatter Forest parkrun	England	United Kingdom
Fell Foot parkrun, Newby Bridge	England	United Kingdom
Ellesmere Port parkrun	England	United Kingdom
Widnes parkrun	England	United Kingdom
Croxteth Hall parkrun	England	United Kingdom
Wilmslow parkrun	England	United Kingdom
Stamford Park parkrun	England	United Kingdom
Birkenhead parkrun	England	United Kingdom
Wilmslow junior parkrun	England	United Kingdom
Witton parkrun	England	United Kingdom
Haigh Woodland parkrun	England	United Kingdom
Stretford parkrun	England	United Kingdom
Crosby parkrun	England	United Kingdom
Lytham Hall parkrun	England	United Kingdom
Warrington junior parkrun	England	United Kingdom
Lancaster parkrun	England	United Kingdom
Northwich junior parkrun	England	United Kingdom
Chadderton Hall parkrun	England	United Kingdom
Carlisle junior parkrun	England	United Kingdom
Alexandra junior parkrun, Oldham	England	United Kingdom
Sale Water parkrun	England	United Kingdom
Blackpool parkrun	England	United Kingdom
Park View junior parkrun	England	United Kingdom
Barrow junior parkrun	England	United Kingdom
Crewe parkrun	England	United Kingdom
Ramsbottom junior parkrun	England	United Kingdom
Macclesfield parkrun	England	United Kingdom
Northwich parkrun	England	United Kingdom
Uppermill junior parkrun	England	United Kingdom
Clitheroe Castle parkrun	England	United Kingdom
Whitehaven parkrun	England	United Kingdom
Fleetwood Promenade parkrun	England	United Kingdom
Wirral Country Park junior parkrun	England	United Kingdom
Seymour Park junior parkrun	England	United Kingdom
Alexandra junior parkrun, Moss Side	England	United Kingdom
Ford parkrun	England	United Kingdom
Milnrow Memorial Park junior parkrun	England	United Kingdom
Fletcher Moss parkrun	England	United Kingdom
Victoria junior parkrun, Macclesfield	England	United Kingdom
Kew Woods parkrun	England	United Kingdom
Morecambe Prom parkrun	England	United Kingdom
Leigh junior parkrun	England	United Kingdom
Peel Park junior parkrun, Little Hulton	England	United Kingdom
The Mystery junior parkrun, Wavertree	England	United Kingdom
The Wirral Way junior parkrun, Parkgate	England	United Kingdom
Tawd Valley parkrun	England	United Kingdom
Padiham Greenway junior parkrun	England	United Kingdom
Phoenix junior parkrun	England	United Kingdom
Alexandra parkrun, Moss Side	England	United Kingdom
Sutton Manor parkrun	England	United Kingdom
Gardenhurst Estate junior parkrun	England	United Kingdom
Derby Park junior parkrun	England	United Kingdom
Worden Park junior parkrun	England	United Kingdom
Rothay Park parkrun	England	United Kingdom
Peel parkrun	England	United Kingdom
Bower Park parkrun	England	United Kingdom
Queens Park junior parkrun, Crewe	England	United Kingdom
Castle Park junior parkrun	England	United Kingdom
Victoria junior parkrun, St Helens	England	United Kingdom
Albert parkrun, Middlesbrough	England	United Kingdom
Silksworth parkrun	England	United Kingdom
Town Moor parkrun	England	United Kingdom
Prudhoe Riverside parkrun	England	United Kingdom
Hemlington Lake junior parkrun	England	United Kingdom
Whitley Bay parkrun	England	United Kingdom
Durham parkrun	England	United Kingdom
Gateshead parkrun	England	United Kingdom
Rossmere junior parkrun	England	United Kingdom
Windy Nook parkrun	England	United Kingdom
Billingham junior parkrun	England	United Kingdom
Durham City junior parkrun	England	United Kingdom
Sedgefield parkrun	England	United Kingdom
Redcar parkrun	England	United Kingdom
Prudhoe Riverside junior parkrun	England	United Kingdom
Blackhill parkrun	England	United Kingdom
Riverside parkrun	England	United Kingdom
Tees Barrage parkrun	England	United Kingdom
Stewart parkrun, Middlesbrough	England	United Kingdom
Darlington South Park parkrun	England	United Kingdom
South Shields parkrun	England	United Kingdom
Hackworth parkrun	England	United Kingdom
Hartlepool parkrun	England	United Kingdom
Newbiggin-by-the-Sea parkrun	England	United Kingdom
Flatts Lane parkrun	England	United Kingdom
Gibside parkrun	England	United Kingdom
Rising Sun parkrun	England	United Kingdom
Druridge Bay parkrun	England	United Kingdom
Whitley Bay junior parkrun	England	United Kingdom
Sedgefield junior parkrun	England	United Kingdom
Town Moor junior parkrun	England	United Kingdom
Redcar junior parkrun	England	United Kingdom
Cotsford Fields parkrun	England	United Kingdom
South Park junior parkrun	England	United Kingdom
The Pastures parkrun	England	United Kingdom
Riverside junior parkrun	England	United Kingdom
Marshall Drive parkrun, Brotton	England	United Kingdom
Tyne Green parkrun	England	United Kingdom
Blyth Links parkrun	England	United Kingdom
Herrington Country parkrun	England	United Kingdom
Leazes parkrun	England	United Kingdom
Saltwell junior parkrun	England	United Kingdom
Jesmond Dene parkrun	England	United Kingdom
Jubilee parkrun	England	United Kingdom
Carlisle Park parkrun	England	United Kingdom
Bushy parkrun	England	United Kingdom
Wimbledon Common parkrun	England	United Kingdom
Richmond parkrun	England	United Kingdom
Bedfont Lakes parkrun	England	United Kingdom
Roundshaw Downs parkrun	England	United Kingdom
Finsbury parkrun	England	United Kingdom
Bromley parkrun	England	United Kingdom
Bexley parkrun	England	United Kingdom
Harrow parkrun	England	United Kingdom
Lloyd junior parkrun	England	United Kingdom
Grovelands parkrun, Enfield	England	United Kingdom
Hackney Marshes parkrun	England	United Kingdom
Greenwich parkrun	England	United Kingdom
Old Deer Park parkrun	England	United Kingdom
Hampstead Heath parkrun	England	United Kingdom
Kingston parkrun	England	United Kingdom
Brockwell parkrun, Herne Hill	England	United Kingdom
Queen's Park junior parkrun, London	England	United Kingdom
Beckenham Place parkrun	England	United Kingdom
Highbury Fields parkrun	England	United Kingdom
Osterley junior parkrun	England	United Kingdom
Laleham junior parkrun	England	United Kingdom
Crystal Palace parkrun	England	United Kingdom
London Fields junior parkrun	England	United Kingdom
Valentines parkrun	England	United Kingdom
Oak Hill parkrun	England	United Kingdom
Lloyd parkrun, Croydon	England	United Kingdom
Gunnersbury parkrun	England	United Kingdom
Bushy junior parkrun	England	United Kingdom
South Norwood parkrun	England	United Kingdom
Wanstead Flats parkrun	England	United Kingdom
Riddlesdown parkrun	England	United Kingdom
Acton junior parkrun	England	United Kingdom
Pymmes parkrun	England	United Kingdom
Crystal Palace junior parkrun	England	United Kingdom
Raphael parkrun	England	United Kingdom
Ally Pally parkrun	England	United Kingdom
Wormwood Scrubs parkrun	England	United Kingdom
Hoblingwell parkrun	England	United Kingdom
Mile End parkrun	England	United Kingdom
Dulwich parkrun	England	United Kingdom
Hilly Fields junior parkrun	England	United Kingdom
Beckton parkrun	England	United Kingdom
Gladstone parkrun	England	United Kingdom
Crane Park parkrun	England	United Kingdom
Hilly Fields parkrun	England	United Kingdom
Burgess parkrun	England	United Kingdom
Orpington parkrun	England	United Kingdom
Barking parkrun	England	United Kingdom
Harrow Lodge parkrun	England	United Kingdom
Walthamstow parkrun	England	United Kingdom
Southwark parkrun	England	United Kingdom
Canons Park parkrun	England	United Kingdom
Osterley parkrun	England	United Kingdom
Fulham Palace parkrun	England	United Kingdom
Northala Fields parkrun	England	United Kingdom
Wimbledon Park junior parkrun	England	United Kingdom
Harrow Lodge junior parkrun	England	United Kingdom
Barking and Dagenham junior parkrun	England	United Kingdom
Brockwell junior parkrun	England	United Kingdom
Mile End junior parkrun	England	United Kingdom
Peckham Rye parkrun	England	United Kingdom
Burgess junior parkrun	England	United Kingdom
Pitshanger junior parkrun	England	United Kingdom
Highbury Fields junior parkrun	England	United Kingdom
Lesnes Abbey Woods junior parkrun	England	United Kingdom
Bromley junior parkrun	England	United Kingdom
Moormead junior parkrun	England	United Kingdom
Surbiton junior parkrun	England	United Kingdom
Tooting Common parkrun	England	United Kingdom
Eltham junior parkrun	England	United Kingdom
Hanworth junior parkrun	England	United Kingdom
Victoria Dock parkrun	England	United Kingdom
Priory Park junior parkrun	England	United Kingdom
Clapham Common parkrun	England	United Kingdom
Catford parkrun	England	United Kingdom
Friary Park junior parkrun	England	United Kingdom
Foots Cray Meadows parkrun	England	United Kingdom
Kenton Rec junior parkrun	England	United Kingdom
Leyton Jubilee junior parkrun	England	United Kingdom
Sunny Hill parkrun	England	United Kingdom
Tooting Common junior parkrun	England	United Kingdom
Hanworth parkrun	England	United Kingdom
Bethlem Royal Hospital parkrun	England	United Kingdom
Northala Fields junior parkrun	England	United Kingdom
Hoblingwell junior parkrun	England	United Kingdom
Caledonian junior parkrun	England	United Kingdom
Enfield Town junior parkrun	England	United Kingdom
Latchmere Rec junior parkrun	England	United Kingdom
Gorleston Cliffs parkrun	England	United Kingdom
Hadleigh parkrun, Essex	England	United Kingdom
Brentwood junior parkrun	England	United Kingdom
Luton Wardown parkrun	England	United Kingdom
Basildon parkrun	England	United Kingdom
Beehive junior parkrun	England	United Kingdom
Houghton Hall junior parkrun	England	United Kingdom
Central Park junior parkrun	England	United Kingdom
Ipswich parkrun	England	United Kingdom
Bedford junior parkrun	England	United Kingdom
St Albans parkrun	England	United Kingdom
Norwich parkrun	England	United Kingdom
Roding Valley parkrun	England	United Kingdom
Bedford parkrun	England	United Kingdom
Rickmansworth parkrun	England	United Kingdom
Cambridge parkrun	England	United Kingdom
Harlow junior parkrun	England	United Kingdom
Leighton Buzzard junior parkrun	England	United Kingdom
Colchester Castle parkrun	England	United Kingdom
Burnham-on-Crouch parkrun	England	United Kingdom
Westmill parkrun	England	United Kingdom
Stevenage junior parkrun	England	United Kingdom
Leavesden junior parkrun	England	United Kingdom
Jubilee junior parkrun	England	United Kingdom
Bury St Edmunds parkrun	England	United Kingdom
Ferry Meadows parkrun	England	United Kingdom
Maldon Prom parkrun	England	United Kingdom
Billericay parkrun	England	United Kingdom
Stevenage parkrun	England	United Kingdom
Gunpowder parkrun	England	United Kingdom
King's Lynn parkrun	England	United Kingdom
Colney Lane parkrun	England	United Kingdom
Southend parkrun	England	United Kingdom
Houghton Hall parkrun	England	United Kingdom
Gadebridge parkrun	England	United Kingdom
Pinehill junior parkrun	England	United Kingdom
Sheringham parkrun	England	United Kingdom
Kesgrave junior parkrun	England	United Kingdom
Chelmsford Central parkrun	England	United Kingdom
Wimpole Estate parkrun	England	United Kingdom
Huntingdon parkrun	England	United Kingdom
Brandon Country Park parkrun	England	United Kingdom
Thetford parkrun	England	United Kingdom
Hawkwell junior parkrun	England	United Kingdom
Clacton Seafront parkrun	England	United Kingdom
Clare Castle parkrun	England	United Kingdom
Brentwood parkrun	England	United Kingdom
Catton parkrun	England	United Kingdom
Blickling parkrun	England	United Kingdom
Bury St Edmunds junior parkrun	England	United Kingdom
Great Cornard parkrun	England	United Kingdom
Chelmsford junior parkrun	England	United Kingdom
Great Notley parkrun	England	United Kingdom
Cambridge junior parkrun	England	United Kingdom
Ipswich junior parkrun	England	United Kingdom
Kesgrave parkrun	England	United Kingdom
Panshanger parkrun	England	United Kingdom
Harlow parkrun	England	United Kingdom
Tring parkrun	England	United Kingdom
Hockley Woods parkrun	England	United Kingdom
South Oxhey parkrun	England	United Kingdom
Cassiobury parkrun	England	United Kingdom
Wimpole Estate junior parkrun	England	United Kingdom
Eaton junior parkrun	England	United Kingdom
Barclay parkrun	England	United Kingdom
Brundall parkrun	England	United Kingdom
Aldenham parkrun	England	United Kingdom
Great Notley junior parkrun	England	United Kingdom
Lowestoft parkrun	England	United Kingdom
Harwich parkrun	England	United Kingdom
Great Cornard junior parkrun	England	United Kingdom
Thurrock parkrun, Orsett Heath	England	United Kingdom
Holkham parkrun	England	United Kingdom
Colchester junior parkrun	England	United Kingdom
Maldon Prom junior parkrun	England	United Kingdom
March parkrun	England	United Kingdom
Ellenbrook Fields parkrun	England	United Kingdom
Gorleston junior parkrun	England	United Kingdom
Mersea Island parkrun	England	United Kingdom
Cheshunt junior parkrun	England	United Kingdom
Castle Park parkrun	England	United Kingdom
Hertford junior parkrun	England	United Kingdom
Letchworth parkrun	England	United Kingdom
South Woodham Ferrers parkrun	England	United Kingdom
Great Denham parkrun	England	United Kingdom
Haverhill parkrun	England	United Kingdom
King's Lynn junior parkrun	England	United Kingdom
Felixstowe parkrun	England	United Kingdom
Great Dunmow parkrun	England	United Kingdom
Wisbech junior parkrun	England	United Kingdom
Swaffham parkrun	England	United Kingdom
Wardown junior parkrun	England	United Kingdom
Pocket parkrun	England	United Kingdom
Littleport parkrun	England	United Kingdom
Cliff Park junior parkrun	England	United Kingdom
Manor Field parkrun, Whittlesey	England	United Kingdom
Sizewell parkrun	England	United Kingdom
King George junior parkrun	England	United Kingdom
Coldham's Common parkrun	England	United Kingdom
Roding Valley junior parkrun	England	United Kingdom
Jersey Farm parkrun	England	United Kingdom
Grange Paddocks junior parkrun	England	United Kingdom
Loch Neaton parkrun, Watton	England	United Kingdom
Dunstable Downs parkrun	England	United Kingdom
Highwoods parkrun	England	United Kingdom
Lingwood parkrun	England	United Kingdom
Millennium Country parkrun, Forest of Marston Vale	England	United Kingdom
Verulamium junior parkrun	England	United Kingdom
Sloughbottom parkrun	England	United Kingdom
Thomas Mills parkrun	England	United Kingdom
Riverside junior parkrun, St Neots	England	United Kingdom
Lea Bridges junior parkrun	England	United Kingdom
Felixstowe Prom junior parkrun	England	United Kingdom
Lake Meadows junior parkrun	England	United Kingdom
Coldham's Common junior parkrun	England	United Kingdom
Hunstanton Promenade parkrun	England	United Kingdom
Breckland Leisure Centre junior parkrun	England	United Kingdom
Soham Village College parkrun	England	United Kingdom
Fulbourn Hospital parkrun	England	United Kingdom
Northlands junior parkrun	England	United Kingdom
Great Yarmouth North Beach parkrun	England	United Kingdom
Wickford Memorial parkrun	England	United Kingdom
Chalkwell Beach parkrun	England	United Kingdom
West End junior parkrun	England	United Kingdom
Henlow Bridge Lakes parkrun	England	United Kingdom
Cambourne junior parkrun	England	United Kingdom
Gadebridge Park junior parkrun	England	United Kingdom
Chilton Fields parkrun	England	United Kingdom
Cardiff parkrun	Wales	United Kingdom
Penallta junior parkrun	Wales	United Kingdom
Riverfront parkrun	Wales	United Kingdom
Llanelli Coast parkrun	Wales	United Kingdom
Newtown parkrun	Wales	United Kingdom
Gnoll junior parkrun	Wales	United Kingdom
Merthyr parkrun	Wales	United Kingdom
Newport parkrun	Wales	United Kingdom
Maesteg parkrun	Wales	United Kingdom
Llanelli Coast junior parkrun	Wales	United Kingdom
Bryn Bach junior parkrun	Wales	United Kingdom
Bryn Bach parkrun	Wales	United Kingdom
Aberystwyth parkrun	Wales	United Kingdom
Llyn Llech Owain parkrun	Wales	United Kingdom
Pontypridd parkrun	Wales	United Kingdom
Porthcawl parkrun	Wales	United Kingdom
Barry junior parkrun	Wales	United Kingdom
Penallta parkrun	Wales	United Kingdom
Haverfordwest parkrun	Wales	United Kingdom
Pontypool parkrun	Wales	United Kingdom
Newport junior parkrun	Wales	United Kingdom
Colby parkrun	Wales	United Kingdom
Penrhyn parkrun	Wales	United Kingdom
Conwy parkrun	Wales	United Kingdom
Pontypool junior parkrun	Wales	United Kingdom
Cardiff junior parkrun	Wales	United Kingdom
Barry Island parkrun	Wales	United Kingdom
Aberystwyth junior parkrun	Wales	United Kingdom
Bridgend junior parkrun	Wales	United Kingdom
Swansea Bay parkrun	Wales	United Kingdom
Grangemoor parkrun	Wales	United Kingdom
Gnoll parkrun	Wales	United Kingdom
Dolgellau parkrun	Wales	United Kingdom
Wepre parkrun	Wales	United Kingdom
Erddig parkrun	Wales	United Kingdom
Carmarthen junior parkrun	Wales	United Kingdom
Cwmbran parkrun	Wales	United Kingdom
Rogiet parkrun	Wales	United Kingdom
Llanerchaeron parkrun	Wales	United Kingdom
Pontypridd junior parkrun	Wales	United Kingdom
Aberdare parkrun	Wales	United Kingdom
Alyn Waters junior parkrun	Wales	United Kingdom
Newborough Forest parkrun	Wales	United Kingdom
Severn Bridge parkrun	Wales	United Kingdom
Nant y Pandy parkrun	Wales	United Kingdom
Prestatyn Prom junior parkrun	Wales	United Kingdom
Aberbeeg parkrun	Wales	United Kingdom
Hafan Pwllheli parkrun	Wales	United Kingdom
Groe parkrun	Wales	United Kingdom
Pont y Bala parkrun	Wales	United Kingdom
Milford Waterfront parkrun	Wales	United Kingdom
Brynaman parkrun	Wales	United Kingdom
Bailey junior parkrun	Wales	United Kingdom
Tremorfa parkrun	Wales	United Kingdom
Conwy Nature Reserve junior parkrun	Wales	United Kingdom
Dixton junior parkrun, Monmouth	Wales	United Kingdom
Nova Prestatyn parkrun	Wales	United Kingdom
Cosmeston Lakes parkrun	Wales	United Kingdom
Rogiet junior parkrun	Wales	United Kingdom
Coed Cefn-pwll-du parkrun	Wales	United Kingdom
Swansea Prom junior parkrun	Wales	United Kingdom
Trelai Park parkrun	Wales	United Kingdom
Greenfield Valley parkrun	Wales	United Kingdom
Colwick parkrun	England	United Kingdom
Braunstone parkrun	England	United Kingdom
Bestwood Village parkrun	England	United Kingdom
Shipley Country parkrun	England	United Kingdom
Boston parkrun	England	United Kingdom
Lincoln parkrun	England	United Kingdom
Rosliston parkrun	England	United Kingdom
Mansfield parkrun	England	United Kingdom
Northampton parkrun	England	United Kingdom
Markeaton parkrun	England	United Kingdom
Brierley Forest parkrun	England	United Kingdom
Kettering parkrun	England	United Kingdom
Market Harborough parkrun	England	United Kingdom
Long Eaton parkrun	England	United Kingdom
Conkers parkrun	England	United Kingdom
Forest Rec junior parkrun	England	United Kingdom
Market Harborough junior parkrun	England	United Kingdom
Rushcliffe parkrun	England	United Kingdom
Forest Rec parkrun	England	United Kingdom
Newark parkrun	England	United Kingdom
Clumber Park parkrun	England	United Kingdom
Corby parkrun	England	United Kingdom
Rushcliffe junior parkrun	England	United Kingdom
Aylestone junior parkrun	England	United Kingdom
Beeston parkrun	England	United Kingdom
Swadlincote junior parkrun	England	United Kingdom
Markeaton junior parkrun	England	United Kingdom
Daventry parkrun	England	United Kingdom
Melton Mowbray parkrun	England	United Kingdom
Gedling parkrun	England	United Kingdom
Glossop parkrun	England	United Kingdom
Long Eaton junior parkrun	England	United Kingdom
Whaley Bridge junior parkrun	England	United Kingdom
Sherwood Pines parkrun	England	United Kingdom
Rutland Water parkrun	England	United Kingdom
Belton House parkrun	England	United Kingdom
Leicester Victoria parkrun	England	United Kingdom
Hucknall junior parkrun	England	United Kingdom
Poolsbrook parkrun	England	United Kingdom
Gedling junior parkrun	England	United Kingdom
Daventry junior parkrun	England	United Kingdom
Melton Mowbray junior parkrun	England	United Kingdom
Clifton parkrun	England	United Kingdom
Bakewell parkrun	England	United Kingdom
Staveley junior parkrun	England	United Kingdom
Sixfields Upton parkrun	England	United Kingdom
Newark junior parkrun	England	United Kingdom
Rutland Water junior parkrun	England	United Kingdom
Dishley parkrun, Loughborough	England	United Kingdom
Watermeadows parkrun	England	United Kingdom
Market Rasen Racecourse parkrun	England	United Kingdom
Worksop College junior parkrun	England	United Kingdom
Snowden Field parkrun	England	United Kingdom
Desborough Green Space junior parkrun	England	United Kingdom
Alvaston parkrun	England	United Kingdom
Shipley Country junior parkrun	England	United Kingdom
Dukeries junior parkrun	England	United Kingdom
Salcey Forest parkrun	England	United Kingdom
Irchester Country parkrun	England	United Kingdom
Wyndham junior parkrun	England	United Kingdom
Wicksteed junior parkrun	England	United Kingdom
Brixworth Country parkrun	England	United Kingdom
Boston Road Rec junior parkrun	England	United Kingdom
Skegness Boating Lake parkrun	England	United Kingdom
Wollaton Hall parkrun	England	United Kingdom
Doddington Hall parkrun	England	United Kingdom
Sutton Lawn junior parkrun	England	United Kingdom
Northampton Racecourse junior parkrun	England	United Kingdom
Spencer Park junior parkrun	England	United Kingdom
Coventry parkrun	England	United Kingdom
Leamington parkrun	England	United Kingdom
Cannock Chase parkrun	England	United Kingdom
Rugby parkrun	England	United Kingdom
Dudley parkrun	England	United Kingdom
Shrewsbury junior parkrun	England	United Kingdom
Bloxwich junior parkrun	England	United Kingdom
Arrow Valley parkrun	England	United Kingdom
Brueton parkrun	England	United Kingdom
Cannon Hill parkrun, Birmingham	England	United Kingdom
Worcester parkrun	England	United Kingdom
Wolverhampton parkrun	England	United Kingdom
Worcester Pitchcroft parkrun	England	United Kingdom
Walsall Arboretum parkrun	England	United Kingdom
Evesham junior parkrun	England	United Kingdom
Sandwell Valley parkrun	England	United Kingdom
Hanley parkrun	England	United Kingdom
Telford parkrun	England	United Kingdom
Kingsbury Water parkrun	England	United Kingdom
Shrewsbury parkrun	England	United Kingdom
Bromsgrove junior parkrun	England	United Kingdom
Hereford parkrun	England	United Kingdom
Perry Hall parkrun	England	United Kingdom
Evesham parkrun	England	United Kingdom
Wednesfield junior parkrun	England	United Kingdom
Telford junior parkrun	England	United Kingdom
Wyre Forest parkrun	England	United Kingdom
Ludlow parkrun	England	United Kingdom
Stratford-upon-Avon parkrun	England	United Kingdom
Cannon Hill junior parkrun, Birmingham	England	United Kingdom
Bedworth parkrun	England	United Kingdom
The Wammy parkrun	England	United Kingdom
Sutton Park parkrun	England	United Kingdom
Longton junior parkrun	England	United Kingdom
Stevens Park junior parkrun, Wollescote	England	United Kingdom
Burslem Park junior parkrun	England	United Kingdom
Henley Wood parkrun, Oswestry	England	United Kingdom
Birches Valley junior parkrun	England	United Kingdom
Isabel Trail parkrun	England	United Kingdom
GEC Rec junior parkrun	England	United Kingdom
Chasewater parkrun	England	United Kingdom
Wyre Forest junior parkrun	England	United Kingdom
Stratford-upon-Avon Rec junior parkrun	England	United Kingdom
Severn Valley Country parkrun	England	United Kingdom
Babbs Mill parkrun	England	United Kingdom
Alderford Lake parkrun	England	United Kingdom
Warwick Racecourse parkrun	England	United Kingdom
Oaklands parkrun	England	United Kingdom
East Park parkrun	England	United Kingdom
Clough Hall junior parkrun	England	United Kingdom
Beacon parkrun	England	United Kingdom
West Smethwick junior parkrun	England	United Kingdom
Edgbaston Reservoir parkrun	England	United Kingdom
War Memorial Park junior parkrun	England	United Kingdom
Rostrevor parkrun	Northern Ireland	United Kingdom
Belfast Victoria junior parkrun	Northern Ireland	United Kingdom
Waterworks parkrun, Belfast	Northern Ireland	United Kingdom
Comber junior parkrun	Northern Ireland	United Kingdom
Derry City parkrun	Northern Ireland	United Kingdom
Jordanstown junior parkrun	Northern Ireland	United Kingdom
Belfast Victoria parkrun	Northern Ireland	United Kingdom
Ecos parkrun, Ballymena	Northern Ireland	United Kingdom
Queen's parkrun, Belfast	Northern Ireland	United Kingdom
Falls parkrun, Belfast	Northern Ireland	United Kingdom
Portrush parkrun	Northern Ireland	United Kingdom
Wallace parkrun, Lisburn	Northern Ireland	United Kingdom
Citypark parkrun, Craigavon	Northern Ireland	United Kingdom
Enniskillen parkrun	Northern Ireland	United Kingdom
MUSA Cookstown parkrun	Northern Ireland	United Kingdom
Omagh parkrun	Northern Ireland	United Kingdom
Ormeau parkrun	Northern Ireland	United Kingdom
Antrim parkrun	Northern Ireland	United Kingdom
Castlewellan parkrun	Northern Ireland	United Kingdom
Armagh parkrun	Northern Ireland	United Kingdom
Larne parkrun	Northern Ireland	United Kingdom
Carrickfergus parkrun	Northern Ireland	United Kingdom
Bangor parkrun, Northern Ireland	Northern Ireland	United Kingdom
Derry City junior parkrun	Northern Ireland	United Kingdom
Comber parkrun	Northern Ireland	United Kingdom
Valley parkrun, Newtownabbey	Northern Ireland	United Kingdom
Limavady parkrun	Northern Ireland	United Kingdom
Portrush junior parkrun	Northern Ireland	United Kingdom
Stormont parkrun	Northern Ireland	United Kingdom
Colin Glen parkrun	Northern Ireland	United Kingdom
Moira junior parkrun	Northern Ireland	United Kingdom
Larne junior parkrun	Northern Ireland	United Kingdom
Bangor junior parkrun	Northern Ireland	United Kingdom
Waterworks junior parkrun	Northern Ireland	United Kingdom
Ormeau junior parkrun	Northern Ireland	United Kingdom
Magherafelt junior parkrun	Northern Ireland	United Kingdom
Lurgan junior parkrun	Northern Ireland	United Kingdom
Lough Moss junior parkrun	Northern Ireland	United Kingdom
Orangefield parkrun	Northern Ireland	United Kingdom
Broadmeadow junior parkrun	Northern Ireland	United Kingdom
Dungannon Park parkrun	Northern Ireland	United Kingdom
Musgrave junior parkrun	Northern Ireland	United Kingdom
Riverside junior parkrun, Ballymoney	Northern Ireland	United Kingdom
Stranmillis College parkrun	Northern Ireland	United Kingdom
Holy Cross College parkrun	Northern Ireland	United Kingdom
Sixmilewater parkrun	Northern Ireland	United Kingdom
Crawfordsburn Country parkrun	Northern Ireland	United Kingdom
Knockbracken Reservoir parkrun	Northern Ireland	United Kingdom
Hillsborough Forest parkrun	Northern Ireland	United Kingdom
Moors Valley junior parkrun	England	United Kingdom
Kingsway parkrun, Gloucester	England	United Kingdom
Ashton Court parkrun	England	United Kingdom
Tamar Trails parkrun	England	United Kingdom
Lydiard parkrun	England	United Kingdom
Forest of Dean parkrun	England	United Kingdom
Cheddar junior parkrun	England	United Kingdom
Plymvalley parkrun	England	United Kingdom
Trelissick parkrun	England	United Kingdom
Torbay Velopark parkrun	England	United Kingdom
Bath Skyline parkrun	England	United Kingdom
Moors Valley parkrun	England	United Kingdom
Bath Odd Down junior parkrun	England	United Kingdom
Eastville junior parkrun	England	United Kingdom
Shepton Mallet parkrun	England	United Kingdom
Minehead parkrun	England	United Kingdom
Bournemouth parkrun	England	United Kingdom
Weymouth junior parkrun	England	United Kingdom
Gloucester North parkrun	England	United Kingdom
Poole parkrun	England	United Kingdom
Killerton parkrun	England	United Kingdom
Upton House parkrun	England	United Kingdom
Eden Project parkrun	England	United Kingdom
Forest of Dean junior parkrun	England	United Kingdom
Page Park junior parkrun	England	United Kingdom
Barnstaple parkrun	England	United Kingdom
Thornbury parkrun	England	United Kingdom
Eastville parkrun	England	United Kingdom
Southwick Country parkrun	England	United Kingdom
Stonehouse parkrun	England	United Kingdom
Chippenham parkrun	England	United Kingdom
Wotton parkrun	England	United Kingdom
Cheltenham parkrun	England	United Kingdom
Newent parkrun, Forest of Dean	England	United Kingdom
Chipping Sodbury parkrun	England	United Kingdom
Seaton parkrun	England	United Kingdom
Bodmin junior parkrun	England	United Kingdom
Yeovil Montacute parkrun	England	United Kingdom
Weymouth parkrun	England	United Kingdom
Longrun Meadow parkrun	England	United Kingdom
Pomphrey Hill parkrun	England	United Kingdom
Lanhydrock parkrun	England	United Kingdom
Little Stoke junior parkrun	England	United Kingdom
Parke parkrun	England	United Kingdom
Blandford parkrun	England	United Kingdom
Exeter Riverside parkrun	England	United Kingdom
Torridge junior parkrun	England	United Kingdom
Tamar Lakes parkrun	England	United Kingdom
Penrose parkrun	England	United Kingdom
Lydiard junior parkrun	England	United Kingdom
Longrun Meadow junior parkrun	England	United Kingdom
Burnham and Highbridge parkrun	England	United Kingdom
Salisbury parkrun	England	United Kingdom
Weston-super-Mare junior parkrun	England	United Kingdom
Tewkesbury parkrun	England	United Kingdom
Heavitree junior parkrun	England	United Kingdom
Cheltenham junior parkrun	England	United Kingdom
Kings Weston junior parkrun	England	United Kingdom
Windmill Hill junior parkrun	England	United Kingdom
Lydney parkrun	England	United Kingdom
Chippenham junior parkrun	England	United Kingdom
Mount Edgcumbe parkrun	England	United Kingdom
Bideford parkrun	England	United Kingdom
Melksham parkrun	England	United Kingdom
Exmouth parkrun	England	United Kingdom
Cirencester parkrun	England	United Kingdom
Gloucester City parkrun	England	United Kingdom
Stonehouse junior parkrun	England	United Kingdom
Heartlands parkrun	England	United Kingdom
Street parkrun	England	United Kingdom
Barnstaple junior parkrun	England	United Kingdom
Devonport junior parkrun	England	United Kingdom
Henstridge Airfield parkrun	England	United Kingdom
Marlborough Common parkrun	England	United Kingdom
Teignmouth Promenade parkrun	England	United Kingdom
Torbay Velopark junior parkrun	England	United Kingdom
Somerdale Pavilion parkrun	England	United Kingdom
Woolacombe Dunes parkrun	England	United Kingdom
Churchill Gardens junior parkrun, Salisbury	England	United Kingdom
Upton House junior parkrun	England	United Kingdom
Haldon Forest parkrun	England	United Kingdom
Par Track junior parkrun	England	United Kingdom
Collett Park junior parkrun	England	United Kingdom
Cranbrook Country Park junior parkrun	England	United Kingdom
Tetbury Goods Shed parkrun	England	United Kingdom
Yeovil Rec junior parkrun	England	United Kingdom
St Mary's parkrun	England	United Kingdom
The Old Showfield parkrun	England	United Kingdom
Ross-on-Wye parkrun	England	United Kingdom
Stratford Park parkrun, Stroud	England	United Kingdom
Mallards Pike parkrun	England	United Kingdom
King George V Playing Field parkrun	England	United Kingdom
Clevedon Salthouse Fields parkrun	England	United Kingdom
Yatton Recreation junior parkrun	England	United Kingdom
Land's End parkrun	England	United Kingdom
Seven Fields parkrun	England	United Kingdom
King George V junior parkrun	England	United Kingdom
Berkeley Green parkrun	England	United Kingdom
Bolberry Down parkrun	England	United Kingdom
Bude Marshes junior parkrun	England	United Kingdom
Slades junior parkrun	England	United Kingdom
Central parkrun, Plymouth	England	United Kingdom
Penryn Campus parkrun	England	United Kingdom
Sharpham Road Playing Fields parkrun	England	United Kingdom
Wotton Community PARC junior parkrun	England	United Kingdom
Banstead Woods parkrun	England	United Kingdom
Brighton & Hove parkrun	England	United Kingdom
Basingstoke parkrun	England	United Kingdom
Reading parkrun	England	United Kingdom
Black Park parkrun	England	United Kingdom
Dover junior parkrun	England	United Kingdom
Banbury parkrun	England	United Kingdom
Eastbourne parkrun	England	United Kingdom
Frimley Lodge parkrun	England	United Kingdom
Southampton parkrun	England	United Kingdom
Andover parkrun	England	United Kingdom
Guildford parkrun	England	United Kingdom
Maidstone parkrun	England	United Kingdom
Oxford parkrun	England	United Kingdom
Harcourt Hill junior parkrun	England	United Kingdom
Southsea parkrun	England	United Kingdom
Havant parkrun	England	United Kingdom
Whiteley parkrun	England	United Kingdom
Ashford parkrun	England	United Kingdom
Milton Keynes parkrun	England	United Kingdom
Bognor Regis junior parkrun	England	United Kingdom
Wycombe Rye junior parkrun	England	United Kingdom
Canterbury parkrun	England	United Kingdom
Nonsuch parkrun	England	United Kingdom
Andover junior parkrun	England	United Kingdom
Royal Tunbridge Wells parkrun	England	United Kingdom
Eastleigh parkrun	England	United Kingdom
Peacehaven parkrun	England	United Kingdom
Margate junior parkrun	England	United Kingdom
Peacehaven junior parkrun	England	United Kingdom
Newbury parkrun	England	United Kingdom
Whitstable parkrun	England	United Kingdom
Bracknell parkrun	England	United Kingdom
Lymington Woodside parkrun	England	United Kingdom
Henley-on-Thames parkrun	England	United Kingdom
Netley Abbey junior parkrun	England	United Kingdom
Stokes Bay junior parkrun	England	United Kingdom
Woking junior parkrun	England	United Kingdom
Medina I.O.W. parkrun	England	United Kingdom
Tonbridge junior parkrun	England	United Kingdom
Winchester parkrun	England	United Kingdom
Wycombe Rye parkrun	England	United Kingdom
Abingdon parkrun	England	United Kingdom
Linford Wood parkrun	England	United Kingdom
Horsham parkrun	England	United Kingdom
Netley Abbey parkrun	England	United Kingdom
Tilgate parkrun	England	United Kingdom
Reigate Priory junior parkrun	England	United Kingdom
Savill Garden junior parkrun	England	United Kingdom
Alice Holt parkrun	England	United Kingdom
Homewood parkrun	England	United Kingdom
Preston Park junior parkrun, Brighton	England	United Kingdom
Woodley parkrun	England	United Kingdom
Upton Court parkrun	England	United Kingdom
Brockenhurst parkrun	England	United Kingdom
Aylesbury parkrun	England	United Kingdom
Bracknell junior parkrun	England	United Kingdom
Didcot parkrun	England	United Kingdom
Clair parkrun	England	United Kingdom
Margate parkrun	England	United Kingdom
Pegwell Bay parkrun	England	United Kingdom
Preston Park parkrun, Brighton	England	United Kingdom
East Grinstead parkrun	England	United Kingdom
Shorne Woods parkrun	England	United Kingdom
Woodley junior parkrun	England	United Kingdom
Queen Elizabeth parkrun	England	United Kingdom
Horsham junior parkrun	England	United Kingdom
Great Lines parkrun, Medway	England	United Kingdom
Tonbridge parkrun	England	United Kingdom
Southampton junior parkrun	England	United Kingdom
Basingstoke junior parkrun	England	United Kingdom
Reigate Priory parkrun	England	United Kingdom
Rushmoor parkrun	England	United Kingdom
Buckingham parkrun	England	United Kingdom
Bognor Regis parkrun	England	United Kingdom
Woking parkrun	England	United Kingdom
Cranleigh parkrun	England	United Kingdom
Chichester parkrun	England	United Kingdom
Dartford parkrun	England	United Kingdom
Chichester junior parkrun	England	United Kingdom
Folkestone parkrun	England	United Kingdom
Whitstable junior parkrun	England	United Kingdom
Harcourt Hill parkrun	England	United Kingdom
Gravesend junior parkrun	England	United Kingdom
Goudhurst junior parkrun	England	United Kingdom
Maidenhead parkrun	England	United Kingdom
Eastney junior parkrun	England	United Kingdom
Hastings parkrun	England	United Kingdom
Lullingstone parkrun	England	United Kingdom
Milton Keynes junior parkrun	England	United Kingdom
Hove Promenade parkrun	England	United Kingdom
Aylesbury junior parkrun	England	United Kingdom
Lee-on-the-Solent parkrun	England	United Kingdom
Medway junior parkrun	England	United Kingdom
Guildford junior parkrun	England	United Kingdom
Haywards Heath junior parkrun	England	United Kingdom
Dartford Heath parkrun	England	United Kingdom
Manor Park junior parkrun	England	United Kingdom
Buckingham junior parkrun	England	United Kingdom
Waterlooville junior parkrun	England	United Kingdom
Malling parkrun	England	United Kingdom
Ashford junior parkrun	England	United Kingdom
Rushmere parkrun	England	United Kingdom
Nonsuch junior parkrun	England	United Kingdom
Bevendean Down parkrun	England	United Kingdom
Sittingbourne parkrun	England	United Kingdom
Dartford junior parkrun	England	United Kingdom
Bedgebury Pinetum parkrun	England	United Kingdom
Portsmouth Lakeside parkrun	England	United Kingdom
Worthing parkrun	England	United Kingdom
Fareham parkrun	England	United Kingdom
Bicester parkrun	England	United Kingdom
Betteshanger junior parkrun	England	United Kingdom
Winchester junior parkrun	England	United Kingdom
Tilgate junior parkrun	England	United Kingdom
Park Wood junior parkrun	England	United Kingdom
Medina I.O.W junior parkrun	England	United Kingdom
Reculver junior parkrun	England	United Kingdom
Mole Valley parkrun	England	United Kingdom
Witney parkrun	England	United Kingdom
Hogmoor Inclosure parkrun	England	United Kingdom
Eastbourne junior parkrun	England	United Kingdom
Hazelwood parkrun	England	United Kingdom
Clacton junior parkrun	England	United Kingdom
Prospect parkrun	England	United Kingdom
New Milton junior parkrun	England	United Kingdom
Ockwells junior parkrun	England	United Kingdom
Cranleigh junior parkrun	England	United Kingdom
Dinton Pastures parkrun	England	United Kingdom
Lancing Beach Green parkrun	England	United Kingdom
Queen's Parade junior parkrun, Aldershot	England	United Kingdom
Higginson parkrun, Marlow	England	United Kingdom
Wendover Woods parkrun	England	United Kingdom
Hove Park junior parkrun	England	United Kingdom
Walmer and Deal Seafront parkrun	England	United Kingdom
Whiteley junior parkrun	England	United Kingdom
Brooklands parkrun	England	United Kingdom
East Brighton parkrun	England	United Kingdom
Paddington Rec junior parkrun	England	United Kingdom
Seaford Beach parkrun	England	United Kingdom
Lakes junior parkrun	England	United Kingdom
California Country parkrun	England	United Kingdom
Littlehampton Prom parkrun	England	United Kingdom
Hogmoor Inclosure junior parkrun	England	United Kingdom
Kingdom parkrun	England	United Kingdom
Uckfield parkrun	England	United Kingdom
Cyclopark parkrun	England	United Kingdom
Salt Hill junior parkrun	England	United Kingdom
Squerryes Winery parkrun	England	United Kingdom
Leatherhead junior parkrun	England	United Kingdom
Ifield Mill Pond parkrun	England	United Kingdom
The Leas parkrun, Minster	England	United Kingdom
Ashlyns junior parkrun	England	United Kingdom
Chipping Norton School parkrun	England	United Kingdom
Sandhurst Memorial parkrun	England	United Kingdom
Florence Park junior parkrun	England	United Kingdom
Whitelands Farm junior parkrun	England	United Kingdom
Worthing Leisure Centre junior parkrun	England	United Kingdom
Millennium Green junior parkrun	England	United Kingdom
Itchen Valley Country parkrun	England	United Kingdom
Dowds Farm junior parkrun	England	United Kingdom
Horspath parkrun	England	United Kingdom
Church Mead parkrun	England	United Kingdom
Faversham Recreation Ground junior parkrun	England	United Kingdom
Woodhouse Moor parkrun	England	United Kingdom
Wakefield Thornes parkrun	England	United Kingdom
Hull parkrun	England	United Kingdom
Cross Flatts junior parkrun	England	United Kingdom
Graves junior parkrun	England	United Kingdom
Endcliffe parkrun	England	United Kingdom
York parkrun	England	United Kingdom
Halifax parkrun	England	United Kingdom
Bradford parkrun	England	United Kingdom
Bramley junior parkrun	England	United Kingdom
Pontefract parkrun	England	United Kingdom
Brighouse parkrun	England	United Kingdom
Catterick parkrun	England	United Kingdom
Harrogate parkrun	England	United Kingdom
Barnsley parkrun	England	United Kingdom
Rothwell parkrun	England	United Kingdom
Huddersfield parkrun	England	United Kingdom
Normanby Hall parkrun	England	United Kingdom
Concord parkrun, Sheffield	England	United Kingdom
Roundhay parkrun	England	United Kingdom
Sewerby parkrun	England	United Kingdom
Graves parkrun	England	United Kingdom
Dewsbury parkrun	England	United Kingdom
Peter Pan parkrun	England	United Kingdom
Goole parkrun	England	United Kingdom
Temple Newsam parkrun	England	United Kingdom
Scunthorpe parkrun	England	United Kingdom
Rotherham parkrun	England	United Kingdom
Rother Valley parkrun	England	United Kingdom
Cross Flatts parkrun	England	United Kingdom
Hillsborough parkrun	England	United Kingdom
Brighouse junior parkrun	England	United Kingdom
Sheffield Castle parkrun	England	United Kingdom
Skipton parkrun	England	United Kingdom
Sandall Park parkrun	England	United Kingdom
Roundhay junior parkrun	England	United Kingdom
Fountains Abbey parkrun	England	United Kingdom
Peter Pan junior parkrun	England	United Kingdom
Cleethorpes parkrun	England	United Kingdom
Huddersfield junior parkrun	England	United Kingdom
Humber Bridge parkrun	England	United Kingdom
Wetherby parkrun	England	United Kingdom
Oakwell Hall parkrun	England	United Kingdom
Nostell parkrun	England	United Kingdom
Temple Newsam junior parkrun	England	United Kingdom
Barnsley junior parkrun	England	United Kingdom
Northallerton parkrun	England	United Kingdom
Horton Park parkrun	England	United Kingdom
Bramley parkrun	England	United Kingdom
Dewsbury junior parkrun	England	United Kingdom
Heslington parkrun	England	United Kingdom
Harrogate junior parkrun	England	United Kingdom
Saltaire junior parkrun	England	United Kingdom
Dalby Forest parkrun	England	United Kingdom
Tolson junior parkrun	England	United Kingdom
Knavesmire junior parkrun	England	United Kingdom
Selby parkrun	England	United Kingdom
Bodington junior parkrun	England	United Kingdom
New Earswick parkrun	England	United Kingdom
Middleton Woods parkrun	England	United Kingdom
Wakefield Thornes junior parkrun	England	United Kingdom
Northallerton junior parkrun	England	United Kingdom
Pontefract junior parkrun	England	United Kingdom
Shelley junior parkrun	England	United Kingdom
Armley parkrun	England	United Kingdom
Cliffe Castle parkrun	England	United Kingdom
Beaumont Park junior parkrun	England	United Kingdom
Myrtle parkrun	England	United Kingdom
Potternewton parkrun	England	United Kingdom
Frickley Country parkrun	England	United Kingdom
Storthes Hall parkrun	England	United Kingdom
Centre Vale parkrun	England	United Kingdom
Alderman Kneeshaw junior parkrun	England	United Kingdom
Penistone parkrun	England	United Kingdom
Conyngham Hall parkrun	England	United Kingdom
Millfield parkrun	England	United Kingdom
Beverley Westwood parkrun	England	United Kingdom
Millhouses parkrun	England	United Kingdom
Cusworth Hall parkrun	England	United Kingdom
Castle Howard parkrun	England	United Kingdom
Sheffield Olympic Legacy Park junior parkrun	England	United Kingdom
Brumby Wood Rec Ground junior parkrun	England	United Kingdom
Bowling Park parkrun	England	United Kingdom
Riverside Gardens junior parkrun	England	United Kingdom
Chevin Forest parkrun	England	United Kingdom
Roberts Park parkrun	England	United Kingdom
Sandall Park junior parkrun	England	United Kingdom
Brayton Academy junior parkrun	England	United Kingdom
The Station junior parkrun	England	United Kingdom
Jersey parkrun	Jersey	United Kingdom
Guernsey parkrun	Guernsey	United Kingdom
The Waterfront junior parkrun	Jersey	United Kingdom
Cape Pembroke Lighthouse parkrun	Falkland Islands	United Kingdom
Nobles parkrun	Douglas	United Kingdom
Roosevelt Island DC parkrun	Washington, D.C.	USA
Mansfield OH parkrun	Ohio	USA
Leakin Park parkrun	Maryland	USA
Livonia parkrun	Michigan	USA
Anacostia parkrun	Washington, D.C.	USA
College Park parkrun	Maryland	USA
Clermont Waterfront parkrun	Florida	USA
Deep Run parkrun	Virginia	USA
Durham NC parkrun	North Carolina	USA
Renton parkrun	Washington	USA
Eagan parkrun	Minnesota	USA
Crissy Field parkrun	California	USA
Fletcher's Cove parkrun	Washington, D.C.	USA
Heritage Harbor parkrun, Ottawa	Illinois	USA
South Boulder Creek parkrun	Colorado	USA
Kensington parkrun	Maryland	USA
Jamaica Pond parkrun	Massachusetts	USA
Aspen parkrun	Colorado	USA
Joe Creason parkrun	Kentucky	USA
Charleston parkrun, West Virginia	West Virginia	USA
Des Moines Creek parkrun	Washington	USA
Mountain Goat Trail parkrun	Tennessee	USA
Delaware and Raritan Canal parkrun	New Jersey	USA
Depot Park parkrun	Florida	USA
Lillie parkrun, Ann Arbor	Michigan	USA
Himmel parkrun	Arizona	USA
Terry Hershey parkrun	Texas	USA
Rec Plex North parkrun	Florida	USA
Sippo Lake parkrun	Ohio	USA
McAllister parkrun	Indiana	USA
Weedon Island Preserve parkrun	Florida	USA
Marsh-Billings-Rockefeller parkrun	Vermont	USA
Oak Grove parkrun	Kentucky	USA
Perrigo parkrun	Washington	USA
Howard Temin Lakeshore Path parkrun	Wisconsin	USA
Rock Creek Trail parkrun	Oregon	USA
Byxbee parkrun	California	USA
Northside Beltline parkrun	Georgia	USA
Ohio and Erie Canal Reservation parkrun	Ohio	USA
Bear Creek Greenbelt parkrun	Texas	USA
Third Creek Greenway parkrun	Tennessee	USA
The Woodlands Waterway parkrun	Texas	USA
Danehy Park parkrun	Massachusetts	USA
Canyon Rim Trail parkrun	Idaho	USA
Creekside parkrun	North Carolina	USA
Peace Valley parkrun	Pennsylvania	USA
Dr Bill Hammond Trails parkrun	Florida	USA
Valentine Peak parkrun	Utah	USA
